Match Number,Round Number,Home Team,Away Team,Result,Winner,Home Team Goals,Away Team Goals,Match Goals,Home Team Name,Away Team Name,Home is Winner,Goal Difference,Home Goals Ratio,Away Goals Ratio,Home Team Evaluation,Away Team Evaluation,Penalties,Penalties Winner
1,1.0,15,27,1 - 2,62,1,2,3,Benfica,CSKA Moscow,0,-1,0.3333333333333333,0.6666666666666666,4.0,17.0,0,
2,1.0,10,19,3 - 0,11,3,0,3,Manchester United,FC Basel,1,3,1.0,0.0,20.0,19.0,0,
13,1.0,1,26,3 - 0,2,3,0,3,Bayern München,Anderlecht,1,3,1.0,0.0,29.0,6.0,0,
14,1.0,25,7,0 - 5,8,0,5,5,Celtic,Paris Saint-Germain,0,-5,0.0,1.0,8.0,19.0,0,
25,1.0,8,28,6 - 0,9,6,0,6,Chelsea,Qarabag FK,1,6,1.0,0.0,18.0,6.0,0,
26,1.0,13,6,0 - 0,7,0,0,0,AS Roma,Atlético Madrid,0,0,,,25.0,28.0,1,7.0
37,1.0,2,5,3 - 0,3,3,0,3,FC Barcelona,Juventus,1,3,1.0,0.0,25.0,23.0,0,
38,1.0,23,20,2 - 3,29,2,3,5,Olympiakos Piraeus,Sporting CP Lisbon,0,-1,0.4,0.6,5.0,17.0,0,
49,1.0,31,30,1 - 1,115,1,1,2,NK Maribor,Spartak Moscow,0,0,0.5,0.5,7.0,11.0,0,
50,1.0,4,9,2 - 2,10,2,2,4,Liverpool,Sevilla,0,0,0.5,0.5,30.0,21.0,0,
61,1.0,21,3,0 - 4,4,0,4,4,Feyenoord,Manchester City,0,-4,0.0,1.0,6.0,22.0,0,
62,1.0,16,14,2 - 1,21,2,1,3,Shakhtar Donetsk,Napoli,1,1,0.6666666666666666,0.3333333333333333,19.0,10.0,0,
73,1.0,18,22,1 - 1,37,1,1,2,RB Leipzig,AS Monaco,0,0,0.5,0.5,17.0,6.0,0,
74,1.0,11,24,1 - 3,46,1,3,4,FC Porto,Besiktas,0,-2,0.25,0.75,17.0,19.0,0,
85,1.0,0,29,3 - 0,1,3,0,3,Real Madrid,APOEL Nicosia,1,3,1.0,0.0,32.0,6.0,0,
86,1.0,17,12,3 - 1,23,3,1,4,Tottenham Hotspur,Borussia Dortmund,1,2,0.75,0.25,21.0,10.0,0,
51,2.0,9,31,3 - 0,10,3,0,3,Sevilla,NK Maribor,1,3,1.0,0.0,21.0,7.0,0,
52,2.0,30,4,1 - 1,5,1,1,2,Spartak Moscow,Liverpool,0,0,0.5,0.5,11.0,30.0,0,
63,2.0,14,21,3 - 1,16,3,1,4,Napoli,Feyenoord,1,2,0.75,0.25,10.0,6.0,0,
64,2.0,3,16,2 - 0,4,2,0,2,Manchester City,Shakhtar Donetsk,1,2,1.0,0.0,22.0,19.0,0,
75,2.0,24,18,2 - 0,46,2,0,2,Besiktas,RB Leipzig,1,2,1.0,0.0,19.0,17.0,0,
76,2.0,22,11,0 - 3,12,0,3,3,AS Monaco,FC Porto,0,-3,0.0,1.0,6.0,17.0,0,
87,2.0,12,0,1 - 3,1,1,3,4,Borussia Dortmund,Real Madrid,0,-2,0.25,0.75,10.0,32.0,0,
88,2.0,29,17,0 - 3,23,0,3,3,APOEL Nicosia,Tottenham Hotspur,0,-3,0.0,1.0,6.0,21.0,0,
27,2.0,28,13,1 - 2,14,1,2,3,Qarabag FK,AS Roma,0,-1,0.3333333333333333,0.6666666666666666,6.0,25.0,0,
3,2.0,19,15,5 - 0,26,5,0,5,FC Basel,Benfica,1,5,1.0,0.0,19.0,4.0,0,
4,2.0,27,10,1 - 4,11,1,4,5,CSKA Moscow,Manchester United,0,-3,0.2,0.8,17.0,20.0,0,
15,2.0,7,1,3 - 0,8,3,0,3,Paris Saint-Germain,Bayern München,1,3,1.0,0.0,19.0,29.0,0,
16,2.0,26,25,0 - 3,50,0,3,3,Anderlecht,Celtic,0,-3,0.0,1.0,6.0,8.0,0,
28,2.0,6,8,1 - 2,9,1,2,3,Atlético Madrid,Chelsea,0,-1,0.3333333333333333,0.6666666666666666,28.0,18.0,0,
39,2.0,20,2,0 - 1,3,0,1,1,Sporting CP Lisbon,FC Barcelona,0,-1,0.0,1.0,17.0,25.0,0,
40,2.0,5,23,2 - 0,6,2,0,2,Juventus,Olympiakos Piraeus,1,2,1.0,0.0,23.0,5.0,0,
53,3.0,30,9,5 - 1,115,5,1,6,Spartak Moscow,Sevilla,1,4,0.8333333333333334,0.16666666666666666,11.0,21.0,0,
54,3.0,31,4,0 - 7,5,0,7,7,NK Maribor,Liverpool,0,-7,0.0,1.0,7.0,30.0,0,
65,3.0,3,14,2 - 1,4,2,1,3,Manchester City,Napoli,1,1,0.6666666666666666,0.3333333333333333,22.0,10.0,0,
66,3.0,21,16,1 - 2,21,1,2,3,Feyenoord,Shakhtar Donetsk,0,-1,0.3333333333333333,0.6666666666666666,6.0,19.0,0,
77,3.0,22,24,1 - 2,46,1,2,3,AS Monaco,Besiktas,0,-1,0.3333333333333333,0.6666666666666666,6.0,19.0,0,
78,3.0,18,11,3 - 2,24,3,2,5,RB Leipzig,FC Porto,1,1,0.6,0.4,17.0,17.0,0,
89,3.0,29,12,1 - 1,13,1,1,2,APOEL Nicosia,Borussia Dortmund,0,0,0.5,0.5,6.0,10.0,0,
90,3.0,0,17,1 - 1,23,1,1,2,Real Madrid,Tottenham Hotspur,0,0,0.5,0.5,32.0,21.0,0,
29,3.0,28,6,0 - 0,7,0,0,0,Qarabag FK,Atlético Madrid,0,0,,,6.0,28.0,1,7.0
5,3.0,27,19,0 - 2,26,0,2,2,CSKA Moscow,FC Basel,0,-2,0.0,1.0,17.0,19.0,0,
6,3.0,15,10,0 - 1,11,0,1,1,Benfica,Manchester United,0,-1,0.0,1.0,4.0,20.0,0,
17,3.0,26,7,0 - 4,8,0,4,4,Anderlecht,Paris Saint-Germain,0,-4,0.0,1.0,6.0,19.0,0,
18,3.0,1,25,3 - 0,2,3,0,3,Bayern München,Celtic,1,3,1.0,0.0,29.0,8.0,0,
30,3.0,8,13,3 - 3,14,3,3,6,Chelsea,AS Roma,0,0,0.5,0.5,18.0,25.0,0,
41,3.0,5,20,2 - 1,6,2,1,3,Juventus,Sporting CP Lisbon,1,1,0.6666666666666666,0.3333333333333333,23.0,17.0,0,
42,3.0,2,23,3 - 1,3,3,1,4,FC Barcelona,Olympiakos Piraeus,1,2,0.75,0.25,25.0,5.0,0,
7,4.0,19,27,1 - 2,62,1,2,3,FC Basel,CSKA Moscow,0,-1,0.3333333333333333,0.6666666666666666,19.0,17.0,0,
8,4.0,10,15,2 - 0,11,2,0,2,Manchester United,Benfica,1,2,1.0,0.0,20.0,4.0,0,
19,4.0,7,26,5 - 0,8,5,0,5,Paris Saint-Germain,Anderlecht,1,5,1.0,0.0,19.0,6.0,0,
20,4.0,25,1,1 - 2,2,1,2,3,Celtic,Bayern München,0,-1,0.3333333333333333,0.6666666666666666,8.0,29.0,0,
31,4.0,6,28,1 - 1,66,1,1,2,Atlético Madrid,Qarabag FK,0,0,0.5,0.5,28.0,6.0,0,
32,4.0,13,8,3 - 0,14,3,0,3,AS Roma,Chelsea,1,3,1.0,0.0,25.0,18.0,0,
43,4.0,20,5,1 - 1,6,1,1,2,Sporting CP Lisbon,Juventus,0,0,0.5,0.5,17.0,23.0,0,
44,4.0,23,2,0 - 0,3,0,0,0,Olympiakos Piraeus,FC Barcelona,0,0,,,5.0,25.0,1,3.0
79,4.0,24,22,1 - 1,37,1,1,2,Besiktas,AS Monaco,0,0,0.5,0.5,19.0,6.0,0,
55,4.0,9,30,2 - 1,10,2,1,3,Sevilla,Spartak Moscow,1,1,0.6666666666666666,0.3333333333333333,21.0,11.0,0,
56,4.0,4,31,3 - 0,5,3,0,3,Liverpool,NK Maribor,1,3,1.0,0.0,30.0,7.0,0,
67,4.0,14,3,2 - 4,4,2,4,6,Napoli,Manchester City,0,-2,0.3333333333333333,0.6666666666666666,10.0,22.0,0,
68,4.0,16,21,3 - 1,21,3,1,4,Shakhtar Donetsk,Feyenoord,1,2,0.75,0.25,19.0,6.0,0,
80,4.0,11,18,3 - 1,12,3,1,4,FC Porto,RB Leipzig,1,2,0.75,0.25,17.0,17.0,0,
91,4.0,12,29,1 - 1,80,1,1,2,Borussia Dortmund,APOEL Nicosia,0,0,0.5,0.5,10.0,6.0,0,
92,4.0,17,0,3 - 1,23,3,1,4,Tottenham Hotspur,Real Madrid,1,2,0.75,0.25,21.0,32.0,0,
57,5.0,30,31,1 - 1,120,1,1,2,Spartak Moscow,NK Maribor,0,0,0.5,0.5,11.0,7.0,0,
81,5.0,24,11,1 - 1,12,1,1,2,Besiktas,FC Porto,0,0,0.5,0.5,19.0,17.0,0,
58,5.0,9,4,3 - 3,5,3,3,6,Sevilla,Liverpool,0,0,0.5,0.5,21.0,30.0,0,
69,5.0,3,21,1 - 0,4,1,0,1,Manchester City,Feyenoord,1,1,1.0,0.0,22.0,6.0,0,
70,5.0,14,16,3 - 0,16,3,0,3,Napoli,Shakhtar Donetsk,1,3,1.0,0.0,10.0,19.0,0,
82,5.0,22,18,1 - 4,24,1,4,5,AS Monaco,RB Leipzig,0,-3,0.2,0.8,6.0,17.0,0,
93,5.0,29,0,0 - 6,1,0,6,6,APOEL Nicosia,Real Madrid,0,-6,0.0,1.0,6.0,32.0,0,
94,5.0,12,17,1 - 2,23,1,2,3,Borussia Dortmund,Tottenham Hotspur,0,-1,0.3333333333333333,0.6666666666666666,10.0,21.0,0,
9,5.0,27,15,2 - 0,62,2,0,2,CSKA Moscow,Benfica,1,2,1.0,0.0,17.0,4.0,0,
33,5.0,28,8,0 - 4,9,0,4,4,Qarabag FK,Chelsea,0,-4,0.0,1.0,6.0,18.0,0,
10,5.0,19,10,1 - 0,26,1,0,1,FC Basel,Manchester United,1,1,1.0,0.0,19.0,20.0,0,
21,5.0,26,1,1 - 2,2,1,2,3,Anderlecht,Bayern München,0,-1,0.3333333333333333,0.6666666666666666,6.0,29.0,0,
22,5.0,7,25,7 - 1,8,7,1,8,Paris Saint-Germain,Celtic,1,6,0.875,0.125,19.0,8.0,0,
34,5.0,6,13,2 - 0,7,2,0,2,Atlético Madrid,AS Roma,1,2,1.0,0.0,28.0,25.0,0,
45,5.0,5,2,0 - 0,3,0,0,0,Juventus,FC Barcelona,0,0,,,23.0,25.0,1,3.0
46,5.0,20,23,3 - 1,29,3,1,4,Sporting CP Lisbon,Olympiakos Piraeus,1,2,0.75,0.25,17.0,5.0,0,
11,6.0,15,19,0 - 2,26,0,2,2,Benfica,FC Basel,0,-2,0.0,1.0,4.0,19.0,0,
12,6.0,10,27,2 - 1,11,2,1,3,Manchester United,CSKA Moscow,1,1,0.6666666666666666,0.3333333333333333,20.0,17.0,0,
23,6.0,1,7,3 - 1,2,3,1,4,Bayern München,Paris Saint-Germain,1,2,0.75,0.25,29.0,19.0,0,
24,6.0,25,26,0 - 1,53,0,1,1,Celtic,Anderlecht,0,-1,0.0,1.0,8.0,6.0,0,
35,6.0,8,6,1 - 1,7,1,1,2,Chelsea,Atlético Madrid,0,0,0.5,0.5,18.0,28.0,0,
36,6.0,13,28,1 - 0,14,1,0,1,AS Roma,Qarabag FK,1,1,1.0,0.0,25.0,6.0,0,
47,6.0,2,20,2 - 0,3,2,0,2,FC Barcelona,Sporting CP Lisbon,1,2,1.0,0.0,25.0,17.0,0,
48,6.0,23,5,0 - 2,6,0,2,2,Olympiakos Piraeus,Juventus,0,-2,0.0,1.0,5.0,23.0,0,
59,6.0,31,9,1 - 1,10,1,1,2,NK Maribor,Sevilla,0,0,0.5,0.5,7.0,21.0,0,
60,6.0,4,30,7 - 0,5,7,0,7,Liverpool,Spartak Moscow,1,7,1.0,0.0,30.0,11.0,0,
71,6.0,21,14,2 - 1,36,2,1,3,Feyenoord,Napoli,1,1,0.6666666666666666,0.3333333333333333,6.0,10.0,0,
72,6.0,16,3,2 - 1,21,2,1,3,Shakhtar Donetsk,Manchester City,1,1,0.6666666666666666,0.3333333333333333,19.0,22.0,0,
83,6.0,18,24,1 - 2,46,1,2,3,RB Leipzig,Besiktas,0,-1,0.3333333333333333,0.6666666666666666,17.0,19.0,0,
84,6.0,11,22,5 - 2,12,5,2,7,FC Porto,AS Monaco,1,3,0.7142857142857143,0.2857142857142857,17.0,6.0,0,
95,6.0,0,12,3 - 2,1,3,2,5,Real Madrid,Borussia Dortmund,1,1,0.6,0.4,32.0,10.0,0,
96,6.0,17,29,3 - 0,23,3,0,3,Tottenham Hotspur,APOEL Nicosia,1,3,1.0,0.0,21.0,6.0,0,
97,7.0,5,17,2 - 2,23,2,2,4,Juventus,Tottenham Hotspur,0,0,0.5,0.5,23.0,21.0,0,
98,7.0,19,3,0 - 4,4,0,4,4,FC Basel,Manchester City,0,-4,0.0,1.0,19.0,22.0,0,
99,7.0,11,4,0 - 5,5,0,5,5,FC Porto,Liverpool,0,-5,0.0,1.0,17.0,30.0,0,
100,7.0,0,7,3 - 1,1,3,1,4,Real Madrid,Paris Saint-Germain,1,2,0.75,0.25,32.0,19.0,0,
101,7.0,8,2,1 - 1,3,1,1,2,Chelsea,FC Barcelona,0,0,0.5,0.5,18.0,25.0,0,
102,7.0,1,24,5 - 0,2,5,0,5,Bayern München,Besiktas,1,5,1.0,0.0,29.0,19.0,0,
103,7.0,9,10,0 - 0,11,0,0,0,Sevilla,Manchester United,0,0,,,21.0,20.0,1,11.0
104,7.0,16,13,2 - 1,21,2,1,3,Shakhtar Donetsk,AS Roma,1,1,0.6666666666666666,0.3333333333333333,19.0,25.0,0,
105,8.0,4,11,0 - 0,12,0,0,0,Liverpool,FC Porto,0,0,,,30.0,17.0,1,12.0
106,8.0,7,0,1 - 2,1,1,2,3,Paris Saint-Germain,Real Madrid,0,-1,0.3333333333333333,0.6666666666666666,19.0,32.0,0,
107,8.0,17,5,1 - 2,6,1,2,3,Tottenham Hotspur,Juventus,0,-1,0.3333333333333333,0.6666666666666666,21.0,23.0,0,
108,8.0,3,19,1 - 2,26,1,2,3,Manchester City,FC Basel,0,-1,0.3333333333333333,0.6666666666666666,22.0,19.0,0,
109,8.0,10,9,1 - 2,10,1,2,3,Manchester United,Sevilla,0,-1,0.3333333333333333,0.6666666666666666,20.0,21.0,0,
110,8.0,13,16,1 - 0,14,1,0,1,AS Roma,Shakhtar Donetsk,1,1,1.0,0.0,25.0,19.0,0,
112,8.0,24,1,1 - 3,2,1,3,4,Besiktas,Bayern München,0,-2,0.25,0.75,19.0,29.0,0,
111,8.0,2,8,3 - 0,3,3,0,3,FC Barcelona,Chelsea,1,3,1.0,0.0,25.0,18.0,0,
113,9.0,9,1,1 - 2,2,1,2,3,Sevilla,Bayern München,0,-1,0.3333333333333333,0.6666666666666666,21.0,29.0,0,
114,9.0,5,0,0 - 3,1,0,3,3,Juventus,Real Madrid,0,-3,0.0,1.0,23.0,32.0,0,
115,9.0,4,3,3 - 0,5,3,0,3,Liverpool,Manchester City,1,3,1.0,0.0,30.0,22.0,0,
116,9.0,2,13,4 - 1,3,4,1,5,FC Barcelona,AS Roma,1,3,0.8,0.2,25.0,25.0,0,
117,10.0,3,4,1 - 2,5,1,2,3,Manchester City,Liverpool,0,-1,0.3333333333333333,0.6666666666666666,22.0,30.0,0,
118,10.0,13,2,3 - 0,14,3,0,3,AS Roma,FC Barcelona,1,3,1.0,0.0,25.0,25.0,0,
119,10.0,1,9,0 - 0,10,0,0,0,Bayern München,Sevilla,0,0,,,29.0,21.0,1,10.0
120,10.0,0,5,1 - 3,6,1,3,4,Real Madrid,Juventus,0,-2,0.25,0.75,32.0,23.0,0,
121,11.0,4,13,5 - 2,5,5,2,7,Liverpool,AS Roma,1,3,0.7142857142857143,0.2857142857142857,30.0,25.0,0,
122,11.0,1,0,1 - 2,1,1,2,3,Bayern München,Real Madrid,0,-1,0.3333333333333333,0.6666666666666666,29.0,32.0,0,
123,12.0,0,1,2 - 2,2,2,2,4,Real Madrid,Bayern München,0,0,0.5,0.5,32.0,29.0,0,
124,12.0,13,4,4 - 2,14,4,2,6,AS Roma,Liverpool,1,2,0.6666666666666666,0.3333333333333333,25.0,30.0,0,
125,13.0,0,4,3 - 1,1,3,1,4,Real Madrid,Liverpool,1,2,0.75,0.25,32.0,30.0,0,
1,1.0,18,23,2 - 1,18,2,1,3,Internazionale,Tottenham Hotspur,1,1,0.6666666666666666,0.3333333333333333,15.0,26.0,0,
2,1.0,3,32,4 - 0,3,4,0,4,FC Barcelona,PSV Eindhoven,1,4,1.0,0.0,30.0,6.0,0,
3,1.0,37,7,1 - 2,7,1,2,3,AS Monaco,Atlético Madrid,0,-1,0.3333333333333333,0.6666666666666666,5.0,20.0,0,
4,1.0,31,13,0 - 1,13,0,1,1,Club Brugge,Borussia Dortmund,0,-1,0.0,1.0,11.0,18.0,0,
5,1.0,570,16,0 - 0,16,0,0,0,Crvena zvezda,Napoli,0,0,,,,18.0,1,16.0
6,1.0,5,8,3 - 2,5,3,2,5,Liverpool,Paris Saint-Germain,1,1,0.6,0.4,29.0,19.0,0,
7,1.0,51,12,1 - 1,12,1,1,2,Schalke 04,FC Porto,0,0,0.5,0.5,17.0,23.0,0,
8,1.0,64,74,3 - 0,64,3,0,3,Galatasaray,Lokomotiv Moscow,1,3,1.0,0.0,8.0,6.0,0,
9,1.0,17,134,3 - 0,17,3,0,3,Ajax,AEK Athens,1,3,1.0,0.0,27.0,4.0,0,
10,1.0,21,111,2 - 2,111,2,2,4,Shakhtar Donetsk,1899 Hoffenheim,0,0,0.5,0.5,10.0,7.0,0,
11,1.0,20,2,0 - 2,2,0,2,2,Benfica,Bayern München,0,-2,0.0,1.0,17.0,20.0,0,
12,1.0,4,27,1 - 2,27,1,2,3,Manchester City,Olympique Lyon,0,-1,0.3333333333333333,0.6666666666666666,25.0,17.0,0,
13,1.0,60,62,2 - 2,62,2,2,4,Viktoria Plzen,CSKA Moscow,0,0,0.5,0.5,11.0,9.0,0,
14,1.0,1,14,3 - 0,1,3,0,3,Real Madrid,AS Roma,1,3,1.0,0.0,19.0,17.0,0,
15,1.0,63,6,0 - 2,6,0,2,2,Valencia,Juventus,0,-2,0.0,1.0,23.0,21.0,0,
16,1.0,55,11,0 - 3,11,0,3,3,Young Boys,Manchester United,0,-3,0.0,1.0,7.0,19.0,0,
17,2.0,111,4,1 - 2,4,1,2,3,1899 Hoffenheim,Manchester City,0,-1,0.3333333333333333,0.6666666666666666,7.0,25.0,0,
18,2.0,6,55,3 - 0,6,3,0,3,Juventus,Young Boys,1,3,1.0,0.0,21.0,7.0,0,
19,2.0,134,20,2 - 3,20,2,3,5,AEK Athens,Benfica,0,-1,0.4,0.6,4.0,17.0,0,
20,2.0,2,17,1 - 1,17,1,1,2,Bayern München,Ajax,0,0,0.5,0.5,20.0,27.0,0,
21,2.0,27,21,2 - 2,21,2,2,4,Olympique Lyon,Shakhtar Donetsk,0,0,0.5,0.5,17.0,10.0,0,
22,2.0,14,60,5 - 0,14,5,0,5,AS Roma,Viktoria Plzen,1,5,1.0,0.0,17.0,11.0,0,
23,2.0,62,1,1 - 0,62,1,0,1,CSKA Moscow,Real Madrid,1,1,1.0,0.0,9.0,19.0,0,
24,2.0,11,63,0 - 0,63,0,0,0,Manchester United,Valencia,0,0,,,19.0,23.0,1,63.0
25,2.0,8,570,6 - 1,8,6,1,7,Paris Saint-Germain,Crvena zvezda,1,5,0.8571428571428571,0.14285714285714285,19.0,,0,
26,2.0,74,51,0 - 1,51,0,1,1,Lokomotiv Moscow,Schalke 04,0,-1,0.0,1.0,6.0,17.0,0,
27,2.0,13,37,3 - 0,13,3,0,3,Borussia Dortmund,AS Monaco,1,3,1.0,0.0,18.0,5.0,0,
28,2.0,7,31,3 - 1,7,3,1,4,Atlético Madrid,Club Brugge,1,2,0.75,0.25,20.0,11.0,0,
29,2.0,32,18,1 - 2,18,1,2,3,PSV Eindhoven,Internazionale,0,-1,0.3333333333333333,0.6666666666666666,6.0,15.0,0,
30,2.0,23,3,2 - 4,3,2,4,6,Tottenham Hotspur,FC Barcelona,0,-2,0.3333333333333333,0.6666666666666666,26.0,30.0,0,
31,2.0,16,5,1 - 0,16,1,0,1,Napoli,Liverpool,1,1,1.0,0.0,18.0,29.0,0,
32,2.0,12,64,1 - 0,12,1,0,1,FC Porto,Galatasaray,1,1,1.0,0.0,23.0,8.0,0,
33,3.0,134,2,0 - 2,2,0,2,2,AEK Athens,Bayern München,0,-2,0.0,1.0,4.0,20.0,0,
34,3.0,55,63,1 - 1,63,1,1,2,Young Boys,Valencia,0,0,0.5,0.5,7.0,23.0,0,
35,3.0,17,20,1 - 0,17,1,0,1,Ajax,Benfica,1,1,1.0,0.0,27.0,17.0,0,
36,3.0,21,4,0 - 3,4,0,3,3,Shakhtar Donetsk,Manchester City,0,-3,0.0,1.0,10.0,25.0,0,
37,3.0,111,27,3 - 3,27,3,3,6,1899 Hoffenheim,Olympique Lyon,0,0,0.5,0.5,7.0,17.0,0,
38,3.0,1,60,2 - 1,1,2,1,3,Real Madrid,Viktoria Plzen,1,1,0.6666666666666666,0.3333333333333333,19.0,11.0,0,
39,3.0,14,62,3 - 0,14,3,0,3,AS Roma,CSKA Moscow,1,3,1.0,0.0,17.0,9.0,0,
40,3.0,11,6,0 - 1,6,0,1,1,Manchester United,Juventus,0,-1,0.0,1.0,19.0,21.0,0,
41,3.0,31,37,1 - 1,37,1,1,2,Club Brugge,AS Monaco,0,0,0.5,0.5,11.0,5.0,0,
42,3.0,32,23,2 - 2,23,2,2,4,PSV Eindhoven,Tottenham Hotspur,0,0,0.5,0.5,6.0,26.0,0,
43,3.0,13,7,4 - 0,13,4,0,4,Borussia Dortmund,Atlético Madrid,1,4,1.0,0.0,18.0,20.0,0,
44,3.0,3,18,2 - 0,3,2,0,2,FC Barcelona,Internazionale,1,2,1.0,0.0,30.0,15.0,0,
45,3.0,5,570,4 - 0,5,4,0,4,Liverpool,Crvena zvezda,1,4,1.0,0.0,29.0,,0,
46,3.0,8,16,2 - 2,16,2,2,4,Paris Saint-Germain,Napoli,0,0,0.5,0.5,19.0,18.0,0,
47,3.0,64,51,0 - 0,51,0,0,0,Galatasaray,Schalke 04,0,0,,,8.0,17.0,1,51.0
48,3.0,74,12,1 - 3,12,1,3,4,Lokomotiv Moscow,FC Porto,0,-2,0.25,0.75,6.0,23.0,0,
49,4.0,37,31,0 - 4,31,0,4,4,AS Monaco,Club Brugge,0,-4,0.0,1.0,5.0,11.0,0,
50,4.0,570,5,2 - 0,570,2,0,2,Crvena zvezda,Liverpool,1,2,1.0,0.0,,29.0,0,
51,4.0,7,13,2 - 0,7,2,0,2,Atlético Madrid,Borussia Dortmund,1,2,1.0,0.0,20.0,18.0,0,
52,4.0,18,3,1 - 1,3,1,1,2,Internazionale,FC Barcelona,0,0,0.5,0.5,15.0,30.0,0,
53,4.0,23,32,2 - 1,23,2,1,3,Tottenham Hotspur,PSV Eindhoven,1,1,0.6666666666666666,0.3333333333333333,26.0,6.0,0,
54,4.0,16,8,1 - 1,8,1,1,2,Napoli,Paris Saint-Germain,0,0,0.5,0.5,18.0,19.0,0,
55,4.0,51,64,2 - 0,51,2,0,2,Schalke 04,Galatasaray,1,2,1.0,0.0,17.0,8.0,0,
56,4.0,12,74,4 - 1,12,4,1,5,FC Porto,Lokomotiv Moscow,1,3,0.8,0.2,23.0,6.0,0,
57,4.0,62,14,1 - 2,14,1,2,3,CSKA Moscow,AS Roma,0,-1,0.3333333333333333,0.6666666666666666,9.0,17.0,0,
58,4.0,63,55,3 - 1,63,3,1,4,Valencia,Young Boys,1,2,0.75,0.25,23.0,7.0,0,
59,4.0,20,17,1 - 1,17,1,1,2,Benfica,Ajax,0,0,0.5,0.5,17.0,27.0,0,
60,4.0,2,134,2 - 0,2,2,0,2,Bayern München,AEK Athens,1,2,1.0,0.0,20.0,4.0,0,
61,4.0,4,21,6 - 0,4,6,0,6,Manchester City,Shakhtar Donetsk,1,6,1.0,0.0,25.0,10.0,0,
62,4.0,27,111,2 - 2,111,2,2,4,Olympique Lyon,1899 Hoffenheim,0,0,0.5,0.5,17.0,7.0,0,
63,4.0,60,1,0 - 5,1,0,5,5,Viktoria Plzen,Real Madrid,0,-5,0.0,1.0,11.0,19.0,0,
64,4.0,6,11,1 - 2,11,1,2,3,Juventus,Manchester United,0,-1,0.3333333333333333,0.6666666666666666,21.0,19.0,0,
65,5.0,134,17,0 - 2,17,0,2,2,AEK Athens,Ajax,0,-2,0.0,1.0,4.0,27.0,0,
66,5.0,62,60,1 - 2,60,1,2,3,CSKA Moscow,Viktoria Plzen,0,-1,0.3333333333333333,0.6666666666666666,9.0,11.0,0,
67,5.0,2,20,5 - 1,2,5,1,6,Bayern München,Benfica,1,4,0.8333333333333334,0.16666666666666666,20.0,17.0,0,
68,5.0,27,4,2 - 2,4,2,2,4,Olympique Lyon,Manchester City,0,0,0.5,0.5,17.0,25.0,0,
69,5.0,111,21,2 - 3,21,2,3,5,1899 Hoffenheim,Shakhtar Donetsk,0,-1,0.4,0.6,7.0,10.0,0,
70,5.0,14,1,0 - 2,1,0,2,2,AS Roma,Real Madrid,0,-2,0.0,1.0,17.0,19.0,0,
71,5.0,6,63,1 - 0,6,1,0,1,Juventus,Valencia,1,1,1.0,0.0,21.0,23.0,0,
72,5.0,11,55,1 - 0,11,1,0,1,Manchester United,Young Boys,1,1,1.0,0.0,19.0,7.0,0,
73,5.0,7,37,2 - 0,7,2,0,2,Atlético Madrid,AS Monaco,1,2,1.0,0.0,20.0,5.0,0,
74,5.0,74,64,2 - 0,74,2,0,2,Lokomotiv Moscow,Galatasaray,1,2,1.0,0.0,6.0,8.0,0,
75,5.0,13,31,0 - 0,31,0,0,0,Borussia Dortmund,Club Brugge,0,0,,,18.0,11.0,1,31.0
76,5.0,23,18,1 - 0,23,1,0,1,Tottenham Hotspur,Internazionale,1,1,1.0,0.0,26.0,15.0,0,
77,5.0,32,3,1 - 2,3,1,2,3,PSV Eindhoven,FC Barcelona,0,-1,0.3333333333333333,0.6666666666666666,6.0,30.0,0,
78,5.0,16,570,3 - 1,16,3,1,4,Napoli,Crvena zvezda,1,2,0.75,0.25,18.0,,0,
79,5.0,8,5,2 - 1,8,2,1,3,Paris Saint-Germain,Liverpool,1,1,0.6666666666666666,0.3333333333333333,19.0,29.0,0,
80,5.0,12,51,3 - 1,12,3,1,4,FC Porto,Schalke 04,1,2,0.75,0.25,23.0,17.0,0,
81,6.0,51,74,1 - 0,51,1,0,1,Schalke 04,Lokomotiv Moscow,1,1,1.0,0.0,17.0,6.0,0,
82,6.0,64,12,2 - 3,12,2,3,5,Galatasaray,FC Porto,0,-1,0.4,0.6,8.0,23.0,0,
83,6.0,37,13,0 - 2,13,0,2,2,AS Monaco,Borussia Dortmund,0,-2,0.0,1.0,5.0,18.0,0,
84,6.0,31,7,0 - 0,7,0,0,0,Club Brugge,Atlético Madrid,0,0,,,11.0,20.0,1,7.0
85,6.0,18,32,1 - 1,32,1,1,2,Internazionale,PSV Eindhoven,0,0,0.5,0.5,15.0,6.0,0,
86,6.0,3,23,1 - 1,23,1,1,2,FC Barcelona,Tottenham Hotspur,0,0,0.5,0.5,30.0,26.0,0,
87,6.0,570,8,1 - 4,8,1,4,5,Crvena zvezda,Paris Saint-Germain,0,-3,0.2,0.8,,19.0,0,
88,6.0,5,16,1 - 0,5,1,0,1,Liverpool,Napoli,1,1,1.0,0.0,29.0,18.0,0,
89,6.0,60,14,2 - 1,60,2,1,3,Viktoria Plzen,AS Roma,1,1,0.6666666666666666,0.3333333333333333,11.0,17.0,0,
90,6.0,1,62,0 - 3,62,0,3,3,Real Madrid,CSKA Moscow,0,-3,0.0,1.0,19.0,9.0,0,
91,6.0,20,134,1 - 0,20,1,0,1,Benfica,AEK Athens,1,1,1.0,0.0,17.0,4.0,0,
92,6.0,17,2,3 - 3,2,3,3,6,Ajax,Bayern München,0,0,0.5,0.5,27.0,20.0,0,
93,6.0,4,111,2 - 1,4,2,1,3,Manchester City,1899 Hoffenheim,1,1,0.6666666666666666,0.3333333333333333,25.0,7.0,0,
94,6.0,21,27,1 - 1,27,1,1,2,Shakhtar Donetsk,Olympique Lyon,0,0,0.5,0.5,10.0,17.0,0,
95,6.0,63,11,2 - 1,63,2,1,3,Valencia,Manchester United,1,1,0.6666666666666666,0.3333333333333333,23.0,19.0,0,
96,6.0,55,6,2 - 1,55,2,1,3,Young Boys,Juventus,1,1,0.6666666666666666,0.3333333333333333,7.0,21.0,0,
97,7.0,14,12,2 - 1,14,2,1,3,AS Roma,FC Porto,1,1,0.6666666666666666,0.3333333333333333,17.0,23.0,0,
98,7.0,11,8,0 - 2,8,0,2,2,Manchester United,Paris Saint-Germain,0,-2,0.0,1.0,19.0,19.0,0,
99,7.0,23,13,3 - 0,23,3,0,3,Tottenham Hotspur,Borussia Dortmund,1,3,1.0,0.0,26.0,18.0,0,
100,7.0,17,1,1 - 2,1,1,2,3,Ajax,Real Madrid,0,-1,0.3333333333333333,0.6666666666666666,27.0,19.0,0,
101,7.0,27,3,0 - 0,3,0,0,0,Olympique Lyon,FC Barcelona,0,0,,,17.0,30.0,1,3.0
102,7.0,5,2,0 - 0,2,0,0,0,Liverpool,Bayern München,0,0,,,29.0,20.0,1,2.0
103,7.0,7,6,2 - 0,7,2,0,2,Atlético Madrid,Juventus,1,2,1.0,0.0,20.0,21.0,0,
104,7.0,51,4,2 - 3,4,2,3,5,Schalke 04,Manchester City,0,-1,0.4,0.6,17.0,25.0,0,
105,8.0,13,23,0 - 1,23,0,1,1,Borussia Dortmund,Tottenham Hotspur,0,-1,0.0,1.0,18.0,26.0,0,
106,8.0,1,17,1 - 4,17,1,4,5,Real Madrid,Ajax,0,-3,0.2,0.8,19.0,27.0,0,
107,8.0,8,11,1 - 3,11,1,3,4,Paris Saint-Germain,Manchester United,0,-2,0.25,0.75,19.0,19.0,0,
108,8.0,12,14,3 - 1,12,3,1,4,FC Porto,AS Roma,1,2,0.75,0.25,23.0,17.0,0,
109,8.0,6,7,3 - 0,6,3,0,3,Juventus,Atlético Madrid,1,3,1.0,0.0,21.0,20.0,0,
110,8.0,4,51,7 - 0,4,7,0,7,Manchester City,Schalke 04,1,7,1.0,0.0,25.0,17.0,0,
111,8.0,3,27,5 - 1,3,5,1,6,FC Barcelona,Olympique Lyon,1,4,0.8333333333333334,0.16666666666666666,30.0,17.0,0,
112,8.0,2,5,1 - 3,5,1,3,4,Bayern München,Liverpool,0,-2,0.25,0.75,20.0,29.0,0,
113,9.0,23,4,1 - 0,23,1,0,1,Tottenham Hotspur,Manchester City,1,1,1.0,0.0,26.0,25.0,0,
114,9.0,5,12,2 - 0,5,2,0,2,Liverpool,FC Porto,1,2,1.0,0.0,29.0,23.0,0,
115,9.0,11,3,0 - 1,3,0,1,1,Manchester United,FC Barcelona,0,-1,0.0,1.0,19.0,30.0,0,
116,9.0,17,6,1 - 1,6,1,1,2,Ajax,Juventus,0,0,0.5,0.5,27.0,21.0,0,
117,10.0,6,17,1 - 2,17,1,2,3,Juventus,Ajax,0,-1,0.3333333333333333,0.6666666666666666,21.0,27.0,0,
118,10.0,3,11,3 - 0,3,3,0,3,FC Barcelona,Manchester United,1,3,1.0,0.0,30.0,19.0,0,
119,10.0,12,5,1 - 4,5,1,4,5,FC Porto,Liverpool,0,-3,0.2,0.8,23.0,29.0,0,
120,10.0,4,23,4 - 3,4,4,3,7,Manchester City,Tottenham Hotspur,1,1,0.5714285714285714,0.42857142857142855,25.0,26.0,0,
121,11.0,23,17,0 - 1,17,0,1,1,Tottenham Hotspur,Ajax,0,-1,0.0,1.0,26.0,27.0,0,
122,11.0,3,5,3 - 0,3,3,0,3,FC Barcelona,Liverpool,1,3,1.0,0.0,30.0,29.0,0,
123,12.0,5,3,4 - 0,5,4,0,4,Liverpool,FC Barcelona,1,4,1.0,0.0,29.0,30.0,0,
124,12.0,17,23,2 - 3,23,2,3,5,Ajax,Tottenham Hotspur,0,-1,0.4,0.6,27.0,26.0,0,
125,13.0,23,5,0 - 2,5,0,2,2,Tottenham Hotspur,Liverpool,0,-2,0.0,1.0,26.0,29.0,0,
1,1.0,18,44,1 - 1,44,1,1,2,Internazionale,Slavia Praha,0,0,0.5,0.5,25.0,6.0,0,
2,1.0,27,30,1 - 1,30,1,1,2,Olympique Lyon,Zenit St. Petersburg,0,0,0.5,0.5,23.0,9.0,0,
3,1.0,16,5,2 - 0,16,2,0,2,Napoli,Liverpool,1,2,1.0,0.0,19.0,18.0,0,
4,1.0,28,78,6 - 2,28,6,2,8,FC Salzburg,Racing Genk,1,4,0.75,0.25,10.0,5.0,0,
5,1.0,13,3,0 - 0,3,0,0,0,Borussia Dortmund,FC Barcelona,0,0,,,18.0,24.0,1,3.0
6,1.0,20,24,1 - 2,24,1,2,3,Benfica,RB Leipzig,0,-1,0.3333333333333333,0.6666666666666666,10.0,27.0,0,
7,1.0,9,63,0 - 1,63,0,1,1,Chelsea,Valencia,0,-1,0.0,1.0,17.0,17.0,0,
8,1.0,17,71,3 - 0,17,3,0,3,Ajax,Lille OSC,1,3,1.0,0.0,13.0,5.0,0,
9,1.0,31,64,0 - 0,64,0,0,0,Club Brugge,Galatasaray,0,0,,,8.0,6.0,1,64.0
10,1.0,41,23,2 - 2,23,2,2,4,Olympiakos Piraeus,Tottenham Hotspur,0,0,0.5,0.5,10.0,16.0,0,
11,1.0,8,1,3 - 0,8,3,0,3,Paris Saint-Germain,Real Madrid,1,3,1.0,0.0,31.0,17.0,0,
12,1.0,2,570,3 - 0,2,3,0,3,Bayern München,Crvena zvezda,1,3,1.0,0.0,36.0,,0,
13,1.0,43,504,4 - 0,43,4,0,4,Dinamo Zagreb,Atlantas Klaipeda,1,4,1.0,0.0,8.0,,0,
14,1.0,21,4,0 - 3,4,0,3,3,Shakhtar Donetsk,Manchester City,0,-3,0.0,1.0,22.0,25.0,0,
15,1.0,22,74,1 - 2,74,1,2,3,Bayer Leverkusen,Lokomotiv Moscow,0,-1,0.3333333333333333,0.6666666666666666,18.0,6.0,0,
16,1.0,7,6,2 - 2,6,2,2,4,Atlético Madrid,Juventus,0,0,0.5,0.5,22.0,22.0,0,
17,2.0,1,31,2 - 2,31,2,2,4,Real Madrid,Club Brugge,0,0,0.5,0.5,17.0,8.0,0,
18,2.0,504,21,1 - 2,21,1,2,3,Atlantas Klaipeda,Shakhtar Donetsk,0,-1,0.3333333333333333,0.6666666666666666,,22.0,0,
19,2.0,64,8,0 - 1,8,0,1,1,Galatasaray,Paris Saint-Germain,0,-1,0.0,1.0,6.0,31.0,0,
20,2.0,23,2,2 - 7,2,2,7,9,Tottenham Hotspur,Bayern München,0,-5,0.2222222222222222,0.7777777777777778,16.0,36.0,0,
21,2.0,570,41,3 - 1,570,3,1,4,Crvena zvezda,Olympiakos Piraeus,1,2,0.75,0.25,,10.0,0,
22,2.0,4,43,2 - 0,4,2,0,2,Manchester City,Dinamo Zagreb,1,2,1.0,0.0,25.0,8.0,0,
23,2.0,6,22,3 - 0,6,3,0,3,Juventus,Bayer Leverkusen,1,3,1.0,0.0,22.0,18.0,0,
24,2.0,74,7,0 - 2,7,0,2,2,Lokomotiv Moscow,Atlético Madrid,0,-2,0.0,1.0,6.0,22.0,0,
25,2.0,78,16,0 - 0,16,0,0,0,Racing Genk,Napoli,0,0,,,5.0,19.0,1,16.0
26,2.0,44,13,0 - 2,13,0,2,2,Slavia Praha,Borussia Dortmund,0,-2,0.0,1.0,6.0,18.0,0,
27,2.0,5,28,4 - 3,5,4,3,7,Liverpool,FC Salzburg,1,1,0.5714285714285714,0.42857142857142855,18.0,10.0,0,
28,2.0,3,18,2 - 1,3,2,1,3,FC Barcelona,Internazionale,1,1,0.6666666666666666,0.3333333333333333,24.0,25.0,0,
29,2.0,24,27,0 - 2,27,0,2,2,RB Leipzig,Olympique Lyon,0,-2,0.0,1.0,27.0,23.0,0,
30,2.0,30,20,3 - 1,30,3,1,4,Zenit St. Petersburg,Benfica,1,2,0.75,0.25,9.0,10.0,0,
31,2.0,71,9,1 - 2,9,1,2,3,Lille OSC,Chelsea,0,-1,0.3333333333333333,0.6666666666666666,5.0,17.0,0,
32,2.0,63,17,0 - 3,17,0,3,3,Valencia,Ajax,0,-3,0.0,1.0,17.0,13.0,0,
33,3.0,21,43,2 - 2,43,2,2,4,Shakhtar Donetsk,Dinamo Zagreb,0,0,0.5,0.5,22.0,8.0,0,
34,3.0,7,22,1 - 0,7,1,0,1,Atlético Madrid,Bayer Leverkusen,1,1,1.0,0.0,22.0,18.0,0,
35,3.0,31,8,0 - 5,8,0,5,5,Club Brugge,Paris Saint-Germain,0,-5,0.0,1.0,8.0,31.0,0,
36,3.0,64,1,0 - 1,1,0,1,1,Galatasaray,Real Madrid,0,-1,0.0,1.0,6.0,17.0,0,
37,3.0,41,2,2 - 3,2,2,3,5,Olympiakos Piraeus,Bayern München,0,-1,0.4,0.6,10.0,36.0,0,
38,3.0,23,570,5 - 0,23,5,0,5,Tottenham Hotspur,Crvena zvezda,1,5,1.0,0.0,16.0,,0,
39,3.0,4,504,5 - 1,4,5,1,6,Manchester City,Atlantas Klaipeda,1,4,0.8333333333333334,0.16666666666666666,25.0,,0,
40,3.0,6,74,2 - 1,6,2,1,3,Juventus,Lokomotiv Moscow,1,1,0.6666666666666666,0.3333333333333333,22.0,6.0,0,
41,3.0,24,30,2 - 1,24,2,1,3,RB Leipzig,Zenit St. Petersburg,1,1,0.6666666666666666,0.3333333333333333,27.0,9.0,0,
42,3.0,17,9,0 - 1,9,0,1,1,Ajax,Chelsea,0,-1,0.0,1.0,13.0,17.0,0,
43,3.0,28,16,2 - 3,16,2,3,5,FC Salzburg,Napoli,0,-1,0.4,0.6,10.0,19.0,0,
44,3.0,78,5,1 - 4,5,1,4,5,Racing Genk,Liverpool,0,-3,0.2,0.8,5.0,18.0,0,
45,3.0,18,13,2 - 0,18,2,0,2,Internazionale,Borussia Dortmund,1,2,1.0,0.0,25.0,18.0,0,
46,3.0,44,3,1 - 2,3,1,2,3,Slavia Praha,FC Barcelona,0,-1,0.3333333333333333,0.6666666666666666,6.0,24.0,0,
47,3.0,20,27,2 - 1,20,2,1,3,Benfica,Olympique Lyon,1,1,0.6666666666666666,0.3333333333333333,10.0,23.0,0,
48,3.0,71,63,1 - 1,63,1,1,2,Lille OSC,Valencia,0,0,0.5,0.5,5.0,17.0,0,
49,4.0,3,44,0 - 0,44,0,0,0,FC Barcelona,Slavia Praha,0,0,,,24.0,6.0,1,44.0
50,4.0,30,24,0 - 2,24,0,2,2,Zenit St. Petersburg,RB Leipzig,0,-2,0.0,1.0,9.0,27.0,0,
51,4.0,16,28,1 - 1,28,1,1,2,Napoli,FC Salzburg,0,0,0.5,0.5,19.0,10.0,0,
52,4.0,5,78,2 - 1,5,2,1,3,Liverpool,Racing Genk,1,1,0.6666666666666666,0.3333333333333333,18.0,5.0,0,
53,4.0,13,18,3 - 2,13,3,2,5,Borussia Dortmund,Internazionale,1,1,0.6,0.4,18.0,25.0,0,
54,4.0,27,20,3 - 1,27,3,1,4,Olympique Lyon,Benfica,1,2,0.75,0.25,23.0,10.0,0,
55,4.0,9,17,4 - 4,17,4,4,8,Chelsea,Ajax,0,0,0.5,0.5,17.0,13.0,0,
56,4.0,63,71,4 - 1,63,4,1,5,Valencia,Lille OSC,1,3,0.8,0.2,17.0,5.0,0,
57,4.0,2,41,2 - 0,2,2,0,2,Bayern München,Olympiakos Piraeus,1,2,1.0,0.0,36.0,10.0,0,
58,4.0,74,6,1 - 2,6,1,2,3,Lokomotiv Moscow,Juventus,0,-1,0.3333333333333333,0.6666666666666666,6.0,22.0,0,
59,4.0,8,31,1 - 0,8,1,0,1,Paris Saint-Germain,Club Brugge,1,1,1.0,0.0,31.0,8.0,0,
60,4.0,1,64,6 - 0,1,6,0,6,Real Madrid,Galatasaray,1,6,1.0,0.0,17.0,6.0,0,
61,4.0,570,23,0 - 4,23,0,4,4,Crvena zvezda,Tottenham Hotspur,0,-4,0.0,1.0,,16.0,0,
62,4.0,43,21,3 - 3,21,3,3,6,Dinamo Zagreb,Shakhtar Donetsk,0,0,0.5,0.5,8.0,22.0,0,
63,4.0,504,4,1 - 1,4,1,1,2,Atlantas Klaipeda,Manchester City,0,0,0.5,0.5,,25.0,0,
64,4.0,22,7,2 - 1,22,2,1,3,Bayer Leverkusen,Atlético Madrid,1,1,0.6666666666666666,0.3333333333333333,18.0,22.0,0,
65,5.0,64,31,1 - 1,31,1,1,2,Galatasaray,Club Brugge,0,0,0.5,0.5,6.0,8.0,0,
66,5.0,74,22,0 - 2,22,0,2,2,Lokomotiv Moscow,Bayer Leverkusen,0,-2,0.0,1.0,6.0,18.0,0,
67,5.0,1,8,2 - 2,8,2,2,4,Real Madrid,Paris Saint-Germain,0,0,0.5,0.5,17.0,31.0,0,
68,5.0,570,2,0 - 6,2,0,6,6,Crvena zvezda,Bayern München,0,-6,0.0,1.0,,36.0,0,
69,5.0,23,41,4 - 2,23,4,2,6,Tottenham Hotspur,Olympiakos Piraeus,1,2,0.6666666666666666,0.3333333333333333,16.0,10.0,0,
70,5.0,504,43,2 - 0,504,2,0,2,Atlantas Klaipeda,Dinamo Zagreb,1,2,1.0,0.0,,8.0,0,
71,5.0,4,21,1 - 1,21,1,1,2,Manchester City,Shakhtar Donetsk,0,0,0.5,0.5,25.0,22.0,0,
72,5.0,6,7,1 - 0,6,1,0,1,Juventus,Atlético Madrid,1,1,1.0,0.0,22.0,22.0,0,
73,5.0,30,27,2 - 0,30,2,0,2,Zenit St. Petersburg,Olympique Lyon,1,2,1.0,0.0,9.0,23.0,0,
74,5.0,63,9,2 - 2,9,2,2,4,Valencia,Chelsea,0,0,0.5,0.5,17.0,17.0,0,
75,5.0,5,16,1 - 1,16,1,1,2,Liverpool,Napoli,0,0,0.5,0.5,18.0,19.0,0,
76,5.0,78,28,1 - 4,28,1,4,5,Racing Genk,FC Salzburg,0,-3,0.2,0.8,5.0,10.0,0,
77,5.0,3,13,3 - 1,3,3,1,4,FC Barcelona,Borussia Dortmund,1,2,0.75,0.25,24.0,18.0,0,
78,5.0,44,18,1 - 3,18,1,3,4,Slavia Praha,Internazionale,0,-2,0.25,0.75,6.0,25.0,0,
79,5.0,24,20,2 - 2,20,2,2,4,RB Leipzig,Benfica,0,0,0.5,0.5,27.0,10.0,0,
80,5.0,71,17,0 - 2,17,0,2,2,Lille OSC,Ajax,0,-2,0.0,1.0,5.0,13.0,0,
81,6.0,16,78,4 - 0,16,4,0,4,Napoli,Racing Genk,1,4,1.0,0.0,19.0,5.0,0,
82,6.0,28,5,0 - 2,5,0,2,2,FC Salzburg,Liverpool,0,-2,0.0,1.0,10.0,18.0,0,
83,6.0,13,44,2 - 1,13,2,1,3,Borussia Dortmund,Slavia Praha,1,1,0.6666666666666666,0.3333333333333333,18.0,6.0,0,
84,6.0,18,3,1 - 2,3,1,2,3,Internazionale,FC Barcelona,0,-1,0.3333333333333333,0.6666666666666666,25.0,24.0,0,
85,6.0,27,24,2 - 2,24,2,2,4,Olympique Lyon,RB Leipzig,0,0,0.5,0.5,23.0,27.0,0,
86,6.0,20,30,3 - 0,20,3,0,3,Benfica,Zenit St. Petersburg,1,3,1.0,0.0,10.0,9.0,0,
87,6.0,9,71,2 - 1,9,2,1,3,Chelsea,Lille OSC,1,1,0.6666666666666666,0.3333333333333333,17.0,5.0,0,
88,6.0,17,63,0 - 1,63,0,1,1,Ajax,Valencia,0,-1,0.0,1.0,13.0,17.0,0,
89,6.0,43,4,1 - 4,4,1,4,5,Dinamo Zagreb,Manchester City,0,-3,0.2,0.8,8.0,25.0,0,
90,6.0,21,504,0 - 3,504,0,3,3,Shakhtar Donetsk,Atlantas Klaipeda,0,-3,0.0,1.0,22.0,,0,
91,6.0,8,64,5 - 0,8,5,0,5,Paris Saint-Germain,Galatasaray,1,5,1.0,0.0,31.0,6.0,0,
92,6.0,31,1,1 - 3,1,1,3,4,Club Brugge,Real Madrid,0,-2,0.25,0.75,8.0,17.0,0,
93,6.0,2,23,3 - 1,2,3,1,4,Bayern München,Tottenham Hotspur,1,2,0.75,0.25,36.0,16.0,0,
94,6.0,41,570,1 - 0,41,1,0,1,Olympiakos Piraeus,Crvena zvezda,1,1,1.0,0.0,10.0,,0,
95,6.0,22,6,0 - 2,6,0,2,2,Bayer Leverkusen,Juventus,0,-2,0.0,1.0,18.0,22.0,0,
96,6.0,7,74,2 - 0,7,2,0,2,Atlético Madrid,Lokomotiv Moscow,1,2,1.0,0.0,22.0,6.0,0,
97,7.0,7,5,1 - 0,7,1,0,1,Atlético Madrid,Liverpool,1,1,1.0,0.0,22.0,18.0,0,
98,7.0,13,8,2 - 1,13,2,1,3,Borussia Dortmund,Paris Saint-Germain,1,1,0.6666666666666666,0.3333333333333333,18.0,31.0,0,
99,7.0,504,63,4 - 1,504,4,1,5,Atlantas Klaipeda,Valencia,1,3,0.8,0.2,,17.0,0,
100,7.0,23,24,0 - 1,24,0,1,1,Tottenham Hotspur,RB Leipzig,0,-1,0.0,1.0,16.0,27.0,0,
101,7.0,9,2,0 - 3,2,0,3,3,Chelsea,Bayern München,0,-3,0.0,1.0,17.0,36.0,0,
102,7.0,16,3,1 - 1,3,1,1,2,Napoli,FC Barcelona,0,0,0.5,0.5,19.0,24.0,0,
103,7.0,27,6,1 - 0,27,1,0,1,Olympique Lyon,Juventus,1,1,1.0,0.0,23.0,22.0,0,
104,7.0,1,4,1 - 2,4,1,2,3,Real Madrid,Manchester City,0,-1,0.3333333333333333,0.6666666666666666,17.0,25.0,0,
105,8.0,63,504,3 - 4,504,3,4,7,Valencia,Atlantas Klaipeda,0,-1,0.42857142857142855,0.5714285714285714,17.0,,0,
106,8.0,24,23,3 - 0,24,3,0,3,RB Leipzig,Tottenham Hotspur,1,3,1.0,0.0,27.0,16.0,0,
107,8.0,5,7,2 - 3,7,2,3,5,Liverpool,Atlético Madrid,0,-1,0.4,0.6,18.0,22.0,0,
108,8.0,8,13,2 - 0,8,2,0,2,Paris Saint-Germain,Borussia Dortmund,1,2,1.0,0.0,31.0,18.0,0,
109,8.0,6,27,2 - 1,6,2,1,3,Juventus,Olympique Lyon,1,1,0.6666666666666666,0.3333333333333333,22.0,23.0,0,
110,8.0,4,1,2 - 1,4,2,1,3,Manchester City,Real Madrid,1,1,0.6666666666666666,0.3333333333333333,25.0,17.0,0,
111,8.0,2,9,4 - 1,2,4,1,5,Bayern München,Chelsea,1,3,0.8,0.2,36.0,17.0,0,
112,8.0,3,16,3 - 1,3,3,1,4,FC Barcelona,Napoli,1,2,0.75,0.25,24.0,19.0,0,
113,9.0,504,8,1 - 2,8,1,2,3,Atlantas Klaipeda,Paris Saint-Germain,0,-1,0.3333333333333333,0.6666666666666666,,31.0,0,
114,9.0,24,7,2 - 1,24,2,1,3,RB Leipzig,Atlético Madrid,1,1,0.6666666666666666,0.3333333333333333,27.0,22.0,0,
115,9.0,3,2,2 - 8,2,2,8,10,FC Barcelona,Bayern München,0,-6,0.2,0.8,24.0,36.0,0,
116,9.0,4,27,1 - 3,27,1,3,4,Manchester City,Olympique Lyon,0,-2,0.25,0.75,25.0,23.0,0,
121,10.0,24,8,0 - 3,8,0,3,3,RB Leipzig,Paris Saint-Germain,0,-3,0.0,1.0,27.0,31.0,0,
122,10.0,27,2,0 - 3,2,0,3,3,Olympique Lyon,Bayern München,0,-3,0.0,1.0,23.0,36.0,0,
125,11.0,8,2,0 - 1,2,0,1,1,Paris Saint-Germain,Bayern München,0,-1,0.0,1.0,31.0,36.0,0,
1,1.0,30,31,1 - 2,31,1,2,3,Zenit St. Petersburg,Club Brugge,0,-1,0.3333333333333333,0.6666666666666666,5.0,11.0,0,
2,1.0,33,6,0 - 2,6,0,2,2,Dynamo Kyiv,Juventus,0,-2,0.0,1.0,10.0,21.0,0,
3,1.0,65,70,1 - 1,70,1,1,2,Stade Rennais,FK Krasnodar,0,0,0.5,0.5,5.0,8.0,0,
4,1.0,9,10,0 - 0,10,0,0,0,Chelsea,Sevilla,0,0,,,33.0,19.0,1,10.0
5,1.0,34,13,3 - 1,34,3,1,4,Lazio,Borussia Dortmund,1,2,0.75,0.25,17.0,22.0,0,
6,1.0,3,84,5 - 1,3,5,1,6,FC Barcelona,Ferencváros,1,4,0.8333333333333334,0.16666666666666666,20.0,5.0,0,
7,1.0,8,11,1 - 2,11,1,2,3,Paris Saint-Germain,Manchester United,0,-1,0.3333333333333333,0.6666666666666666,24.0,26.0,0,
8,1.0,24,82,2 - 0,24,2,0,2,RB Leipzig,Istanbul Basaksehir,1,2,1.0,0.0,17.0,6.0,0,
9,1.0,28,74,2 - 2,74,2,2,4,FC Salzburg,Lokomotiv Moscow,0,0,0.5,0.5,7.0,7.0,0,
10,1.0,1,21,2 - 3,21,2,3,5,Real Madrid,Shakhtar Donetsk,0,-1,0.4,0.6,26.0,14.0,0,
11,1.0,2,7,4 - 0,2,4,0,4,Bayern München,Atlético Madrid,1,4,1.0,0.0,27.0,16.0,0,
12,1.0,18,68,2 - 2,68,2,2,4,Internazionale,Borussia Mönchengladbach,0,0,0.5,0.5,9.0,15.0,0,
13,1.0,41,42,1 - 0,41,1,0,1,Olympiakos Piraeus,Olympique Marseille,1,1,1.0,0.0,10.0,6.0,0,
14,1.0,4,12,3 - 1,4,3,1,4,Manchester City,FC Porto,1,2,0.75,0.25,35.0,23.0,0,
15,1.0,17,5,0 - 1,5,0,1,1,Ajax,Liverpool,0,-1,0.0,1.0,19.0,24.0,0,
16,1.0,81,504,0 - 4,504,0,4,4,FC Midtjylland,Atlantas Klaipeda,0,-4,0.0,1.0,6.0,,0,
17,2.0,74,2,1 - 2,2,1,2,3,Lokomotiv Moscow,Bayern München,0,-1,0.3333333333333333,0.6666666666666666,7.0,27.0,0,
18,2.0,21,18,0 - 0,18,0,0,0,Shakhtar Donetsk,Internazionale,0,0,,,14.0,9.0,1,18.0
19,2.0,7,28,3 - 2,7,3,2,5,Atlético Madrid,FC Salzburg,1,1,0.6,0.4,16.0,7.0,0,
20,2.0,68,1,2 - 2,1,2,2,4,Borussia Mönchengladbach,Real Madrid,0,0,0.5,0.5,15.0,26.0,0,
21,2.0,12,41,2 - 0,12,2,0,2,FC Porto,Olympiakos Piraeus,1,2,1.0,0.0,23.0,10.0,0,
22,2.0,42,4,0 - 3,4,0,3,3,Olympique Marseille,Manchester City,0,-3,0.0,1.0,6.0,35.0,0,
23,2.0,504,17,2 - 2,17,2,2,4,Atlantas Klaipeda,Ajax,0,0,0.5,0.5,,19.0,0,
24,2.0,5,81,2 - 0,5,2,0,2,Liverpool,FC Midtjylland,1,2,1.0,0.0,24.0,6.0,0,
25,2.0,70,9,0 - 4,9,0,4,4,FK Krasnodar,Chelsea,0,-4,0.0,1.0,8.0,33.0,0,
26,2.0,82,8,0 - 2,8,0,2,2,Istanbul Basaksehir,Paris Saint-Germain,0,-2,0.0,1.0,6.0,24.0,0,
27,2.0,10,65,1 - 0,10,1,0,1,Sevilla,Stade Rennais,1,1,1.0,0.0,19.0,5.0,0,
28,2.0,31,34,1 - 1,34,1,1,2,Club Brugge,Lazio,0,0,0.5,0.5,11.0,17.0,0,
29,2.0,13,30,2 - 0,13,2,0,2,Borussia Dortmund,Zenit St. Petersburg,1,2,1.0,0.0,22.0,5.0,0,
30,2.0,84,33,2 - 2,33,2,2,4,Ferencváros,Dynamo Kyiv,0,0,0.5,0.5,5.0,10.0,0,
31,2.0,6,3,0 - 2,3,0,2,2,Juventus,FC Barcelona,0,-2,0.0,1.0,21.0,20.0,0,
32,2.0,11,24,5 - 0,11,5,0,5,Manchester United,RB Leipzig,1,5,1.0,0.0,26.0,17.0,0,
33,3.0,74,7,1 - 1,7,1,1,2,Lokomotiv Moscow,Atlético Madrid,0,0,0.5,0.5,7.0,16.0,0,
34,3.0,21,68,0 - 6,68,0,6,6,Shakhtar Donetsk,Borussia Mönchengladbach,0,-6,0.0,1.0,14.0,15.0,0,
35,3.0,28,2,2 - 6,2,2,6,8,FC Salzburg,Bayern München,0,-4,0.25,0.75,7.0,27.0,0,
36,3.0,1,18,3 - 2,1,3,2,5,Real Madrid,Internazionale,1,1,0.6,0.4,26.0,9.0,0,
37,3.0,4,41,3 - 0,4,3,0,3,Manchester City,Olympiakos Piraeus,1,3,1.0,0.0,35.0,10.0,0,
38,3.0,12,42,3 - 0,12,3,0,3,FC Porto,Olympique Marseille,1,3,1.0,0.0,23.0,6.0,0,
39,3.0,81,17,1 - 2,17,1,2,3,FC Midtjylland,Ajax,0,-1,0.3333333333333333,0.6666666666666666,6.0,19.0,0,
40,3.0,504,5,0 - 5,5,0,5,5,Atlantas Klaipeda,Liverpool,0,-5,0.0,1.0,,24.0,0,
41,3.0,30,34,1 - 1,34,1,1,2,Zenit St. Petersburg,Lazio,0,0,0.5,0.5,5.0,17.0,0,
42,3.0,82,11,2 - 1,82,2,1,3,Istanbul Basaksehir,Manchester United,1,1,0.6666666666666666,0.3333333333333333,6.0,26.0,0,
43,3.0,9,65,3 - 0,9,3,0,3,Chelsea,Stade Rennais,1,3,1.0,0.0,33.0,5.0,0,
44,3.0,10,70,3 - 2,10,3,2,5,Sevilla,FK Krasnodar,1,1,0.6,0.4,19.0,8.0,0,
45,3.0,31,13,0 - 3,13,0,3,3,Club Brugge,Borussia Dortmund,0,-3,0.0,1.0,11.0,22.0,0,
46,3.0,3,33,2 - 1,3,2,1,3,FC Barcelona,Dynamo Kyiv,1,1,0.6666666666666666,0.3333333333333333,20.0,10.0,0,
47,3.0,84,6,1 - 4,6,1,4,5,Ferencváros,Juventus,0,-3,0.2,0.8,5.0,21.0,0,
48,3.0,24,8,2 - 1,24,2,1,3,RB Leipzig,Paris Saint-Germain,1,1,0.6666666666666666,0.3333333333333333,17.0,24.0,0,
49,4.0,65,9,1 - 2,9,1,2,3,Stade Rennais,Chelsea,0,-1,0.3333333333333333,0.6666666666666666,5.0,33.0,0,
50,4.0,70,10,1 - 2,10,1,2,3,FK Krasnodar,Sevilla,0,-1,0.3333333333333333,0.6666666666666666,8.0,19.0,0,
51,4.0,34,30,3 - 1,34,3,1,4,Lazio,Zenit St. Petersburg,1,2,0.75,0.25,17.0,5.0,0,
52,4.0,13,31,3 - 0,13,3,0,3,Borussia Dortmund,Club Brugge,1,3,1.0,0.0,22.0,11.0,0,
53,4.0,33,3,0 - 4,3,0,4,4,Dynamo Kyiv,FC Barcelona,0,-4,0.0,1.0,10.0,20.0,0,
54,4.0,6,84,2 - 1,6,2,1,3,Juventus,Ferencváros,1,1,0.6666666666666666,0.3333333333333333,21.0,5.0,0,
55,4.0,8,24,1 - 0,8,1,0,1,Paris Saint-Germain,RB Leipzig,1,1,1.0,0.0,24.0,17.0,0,
56,4.0,11,82,4 - 1,11,4,1,5,Manchester United,Istanbul Basaksehir,1,3,0.8,0.2,26.0,6.0,0,
57,4.0,68,21,4 - 0,68,4,0,4,Borussia Mönchengladbach,Shakhtar Donetsk,1,4,1.0,0.0,15.0,14.0,0,
58,4.0,41,4,0 - 1,4,0,1,1,Olympiakos Piraeus,Manchester City,0,-1,0.0,1.0,10.0,35.0,0,
59,4.0,2,28,3 - 1,2,3,1,4,Bayern München,FC Salzburg,1,2,0.75,0.25,27.0,7.0,0,
60,4.0,7,74,0 - 0,74,0,0,0,Atlético Madrid,Lokomotiv Moscow,0,0,,,16.0,7.0,1,74.0
61,4.0,18,1,0 - 2,1,0,2,2,Internazionale,Real Madrid,0,-2,0.0,1.0,9.0,26.0,0,
62,4.0,42,12,0 - 2,12,0,2,2,Olympique Marseille,FC Porto,0,-2,0.0,1.0,6.0,23.0,0,
63,4.0,17,81,3 - 1,17,3,1,4,Ajax,FC Midtjylland,1,2,0.75,0.25,19.0,6.0,0,
64,4.0,5,504,0 - 2,504,0,2,2,Liverpool,Atlantas Klaipeda,0,-2,0.0,1.0,24.0,,0,
65,5.0,74,28,1 - 3,28,1,3,4,Lokomotiv Moscow,FC Salzburg,0,-2,0.25,0.75,7.0,7.0,0,
66,5.0,21,1,2 - 0,21,2,0,2,Shakhtar Donetsk,Real Madrid,1,2,1.0,0.0,14.0,26.0,0,
67,5.0,7,2,1 - 1,2,1,1,2,Atlético Madrid,Bayern München,0,0,0.5,0.5,16.0,27.0,0,
68,5.0,68,18,2 - 3,18,2,3,5,Borussia Mönchengladbach,Internazionale,0,-1,0.4,0.6,15.0,9.0,0,
69,5.0,42,41,2 - 1,42,2,1,3,Olympique Marseille,Olympiakos Piraeus,1,1,0.6666666666666666,0.3333333333333333,6.0,10.0,0,
70,5.0,12,4,0 - 0,4,0,0,0,FC Porto,Manchester City,0,0,,,23.0,35.0,1,4.0
71,5.0,5,17,1 - 0,5,1,0,1,Liverpool,Ajax,1,1,1.0,0.0,24.0,19.0,0,
72,5.0,504,81,1 - 1,81,1,1,2,Atlantas Klaipeda,FC Midtjylland,0,0,0.5,0.5,,6.0,0,
73,5.0,70,65,1 - 0,70,1,0,1,FK Krasnodar,Stade Rennais,1,1,1.0,0.0,8.0,5.0,0,
74,5.0,82,24,3 - 4,24,3,4,7,Istanbul Basaksehir,RB Leipzig,0,-1,0.42857142857142855,0.5714285714285714,6.0,17.0,0,
75,5.0,10,9,0 - 4,9,0,4,4,Sevilla,Chelsea,0,-4,0.0,1.0,19.0,33.0,0,
76,5.0,13,34,1 - 1,34,1,1,2,Borussia Dortmund,Lazio,0,0,0.5,0.5,22.0,17.0,0,
77,5.0,31,30,3 - 0,31,3,0,3,Club Brugge,Zenit St. Petersburg,1,3,1.0,0.0,11.0,5.0,0,
78,5.0,6,33,3 - 0,6,3,0,3,Juventus,Dynamo Kyiv,1,3,1.0,0.0,21.0,10.0,0,
79,5.0,84,3,0 - 3,3,0,3,3,Ferencváros,FC Barcelona,0,-3,0.0,1.0,5.0,20.0,0,
80,5.0,11,8,1 - 3,8,1,3,4,Manchester United,Paris Saint-Germain,0,-2,0.25,0.75,26.0,24.0,0,
81,6.0,34,31,2 - 2,31,2,2,4,Lazio,Club Brugge,0,0,0.5,0.5,17.0,11.0,0,
82,6.0,30,13,1 - 2,13,1,2,3,Zenit St. Petersburg,Borussia Dortmund,0,-1,0.3333333333333333,0.6666666666666666,5.0,22.0,0,
83,6.0,65,10,1 - 3,10,1,3,4,Stade Rennais,Sevilla,0,-2,0.25,0.75,5.0,19.0,0,
84,6.0,9,70,1 - 1,70,1,1,2,Chelsea,FK Krasnodar,0,0,0.5,0.5,33.0,8.0,0,
85,6.0,33,84,1 - 0,33,1,0,1,Dynamo Kyiv,Ferencváros,1,1,1.0,0.0,10.0,5.0,0,
86,6.0,3,6,0 - 3,6,0,3,3,FC Barcelona,Juventus,0,-3,0.0,1.0,20.0,21.0,0,
88,6.0,24,11,3 - 2,24,3,2,5,RB Leipzig,Manchester United,1,1,0.6,0.4,17.0,26.0,0,
87,6.0,8,82,5 - 1,8,5,1,6,Paris Saint-Germain,Istanbul Basaksehir,1,4,0.8333333333333334,0.16666666666666666,24.0,6.0,0,
89,6.0,17,504,0 - 1,504,0,1,1,Ajax,Atlantas Klaipeda,0,-1,0.0,1.0,19.0,,0,
90,6.0,81,5,1 - 1,5,1,1,2,FC Midtjylland,Liverpool,0,0,0.5,0.5,6.0,24.0,0,
91,6.0,2,74,2 - 0,2,2,0,2,Bayern München,Lokomotiv Moscow,1,2,1.0,0.0,27.0,7.0,0,
92,6.0,28,7,0 - 2,7,0,2,2,FC Salzburg,Atlético Madrid,0,-2,0.0,1.0,7.0,16.0,0,
93,6.0,18,21,0 - 0,21,0,0,0,Internazionale,Shakhtar Donetsk,0,0,,,9.0,14.0,1,21.0
94,6.0,1,68,2 - 0,1,2,0,2,Real Madrid,Borussia Mönchengladbach,1,2,1.0,0.0,26.0,15.0,0,
95,6.0,41,12,0 - 2,12,0,2,2,Olympiakos Piraeus,FC Porto,0,-2,0.0,1.0,10.0,23.0,0,
96,6.0,4,42,3 - 0,4,3,0,3,Manchester City,Olympique Marseille,1,3,1.0,0.0,35.0,6.0,0,
97,7.0,3,8,1 - 4,8,1,4,5,FC Barcelona,Paris Saint-Germain,0,-3,0.2,0.8,20.0,24.0,0,
98,7.0,24,5,0 - 2,5,0,2,2,RB Leipzig,Liverpool,0,-2,0.0,1.0,17.0,24.0,0,
99,7.0,12,6,2 - 1,12,2,1,3,FC Porto,Juventus,1,1,0.6666666666666666,0.3333333333333333,23.0,21.0,0,
100,7.0,10,13,2 - 3,13,2,3,5,Sevilla,Borussia Dortmund,0,-1,0.4,0.6,19.0,22.0,0,
101,7.0,7,9,0 - 1,9,0,1,1,Atlético Madrid,Chelsea,0,-1,0.0,1.0,16.0,33.0,0,
102,7.0,34,2,1 - 4,2,1,4,5,Lazio,Bayern München,0,-3,0.2,0.8,17.0,27.0,0,
103,7.0,504,1,0 - 1,1,0,1,1,Atlantas Klaipeda,Real Madrid,0,-1,0.0,1.0,,26.0,0,
104,7.0,68,4,0 - 2,4,0,2,2,Borussia Mönchengladbach,Manchester City,0,-2,0.0,1.0,15.0,35.0,0,
105,8.0,6,12,3 - 2,6,3,2,5,Juventus,FC Porto,1,1,0.6,0.4,21.0,23.0,0,
106,8.0,13,10,2 - 2,10,2,2,4,Borussia Dortmund,Sevilla,0,0,0.5,0.5,22.0,19.0,0,
107,8.0,5,24,2 - 0,5,2,0,2,Liverpool,RB Leipzig,1,2,1.0,0.0,24.0,17.0,0,
108,8.0,8,3,1 - 1,3,1,1,2,Paris Saint-Germain,FC Barcelona,0,0,0.5,0.5,24.0,20.0,0,
109,8.0,4,68,2 - 0,4,2,0,2,Manchester City,Borussia Mönchengladbach,1,2,1.0,0.0,35.0,15.0,0,
110,8.0,1,504,3 - 1,1,3,1,4,Real Madrid,Atlantas Klaipeda,1,2,0.75,0.25,26.0,,0,
111,8.0,9,7,2 - 0,9,2,0,2,Chelsea,Atlético Madrid,1,2,1.0,0.0,33.0,16.0,0,
112,8.0,2,34,2 - 1,2,2,1,3,Bayern München,Lazio,1,1,0.6666666666666666,0.3333333333333333,27.0,17.0,0,
113,9.0,1,5,3 - 1,1,3,1,4,Real Madrid,Liverpool,1,2,0.75,0.25,26.0,24.0,0,
114,9.0,4,13,2 - 1,4,2,1,3,Manchester City,Borussia Dortmund,1,1,0.6666666666666666,0.3333333333333333,35.0,22.0,0,
115,9.0,2,8,2 - 3,8,2,3,5,Bayern München,Paris Saint-Germain,0,-1,0.4,0.6,27.0,24.0,0,
116,9.0,12,9,0 - 2,9,0,2,2,FC Porto,Chelsea,0,-2,0.0,1.0,23.0,33.0,0,
117,10.0,9,12,0 - 1,12,0,1,1,Chelsea,FC Porto,0,-1,0.0,1.0,33.0,23.0,0,
118,10.0,8,2,0 - 1,2,0,1,1,Paris Saint-Germain,Bayern München,0,-1,0.0,1.0,24.0,27.0,0,
119,10.0,13,4,1 - 2,4,1,2,3,Borussia Dortmund,Manchester City,0,-1,0.3333333333333333,0.6666666666666666,22.0,35.0,0,
120,10.0,5,1,0 - 0,1,0,0,0,Liverpool,Real Madrid,0,0,,,24.0,26.0,1,1.0
121,11.0,1,9,1 - 1,9,1,1,2,Real Madrid,Chelsea,0,0,0.5,0.5,26.0,33.0,0,
122,11.0,8,4,1 - 2,4,1,2,3,Paris Saint-Germain,Manchester City,0,-1,0.3333333333333333,0.6666666666666666,24.0,35.0,0,
123,12.0,4,8,2 - 0,4,2,0,2,Manchester City,Paris Saint-Germain,1,2,1.0,0.0,35.0,24.0,0,
124,12.0,9,1,2 - 0,9,2,0,2,Chelsea,Real Madrid,1,2,1.0,0.0,33.0,26.0,0,
125,13.0,4,9,0 - 1,9,0,1,1,Manchester City,Chelsea,0,-1,0.0,1.0,35.0,33.0,0,
2,1.0,55,11,2 - 1,55,2,1,3,Young Boys,Manchester United,1,1,0.6666666666666666,0.3333333333333333,8.0,18.0,0,
3,1.0,10,28,1 - 1,28,1,1,2,Sevilla,FC Salzburg,0,0,0.5,0.5,12.0,17.0,0,
1,1.0,19,504,2 - 2,504,2,2,4,Villarreal,Atlantas Klaipeda,0,0,0.5,0.5,24.0,,0,
4,1.0,33,20,0 - 0,20,0,0,0,Dynamo Kyiv,Benfica,0,0,,,5.0,20.0,1,20.0
5,1.0,3,2,0 - 3,2,0,3,3,FC Barcelona,Bayern München,0,-3,0.0,1.0,15.0,26.0,0,
6,1.0,71,54,0 - 0,54,0,0,0,Lille OSC,VfL Wolfsburg,0,0,,,17.0,8.0,1,54.0
7,1.0,86,6,0 - 3,6,0,3,3,Malmö FF,Juventus,0,-3,0.0,1.0,5.0,20.0,0,
8,1.0,9,30,1 - 0,9,1,0,1,Chelsea,Zenit St. Petersburg,1,1,1.0,0.0,25.0,8.0,0,
9,1.0,46,13,1 - 2,13,1,2,3,Besiktas,Borussia Dortmund,0,-1,0.3333333333333333,0.6666666666666666,4.0,10.0,0,
10,1.0,104,21,2 - 0,104,2,0,2,Sheriff Tiraspol,Shakhtar Donetsk,1,2,1.0,0.0,9.0,6.0,0,
11,1.0,31,8,1 - 1,8,1,1,2,Club Brugge,Paris Saint-Germain,0,0,0.5,0.5,7.0,19.0,0,
12,1.0,4,24,6 - 3,4,6,3,9,Manchester City,RB Leipzig,1,3,0.6666666666666666,0.3333333333333333,27.0,17.0,0,
13,1.0,7,12,0 - 0,12,0,0,0,Atlético Madrid,FC Porto,0,0,,,19.0,10.0,1,12.0
14,1.0,5,25,3 - 2,5,3,2,5,Liverpool,AC Milan,1,1,0.6,0.4,33.0,7.0,0,
15,1.0,29,17,1 - 5,17,1,5,6,Sporting CP Lisbon,Ajax,0,-4,0.16666666666666666,0.8333333333333334,16.0,22.0,0,
16,1.0,18,1,0 - 1,1,0,1,1,Internazionale,Real Madrid,0,-1,0.0,1.0,18.0,30.0,0,
17,2.0,17,46,2 - 0,17,2,0,2,Ajax,Besiktas,1,2,1.0,0.0,22.0,4.0,0,
18,2.0,21,18,0 - 0,18,0,0,0,Shakhtar Donetsk,Internazionale,0,0,,,6.0,18.0,1,18.0
19,2.0,8,4,2 - 0,8,2,0,2,Paris Saint-Germain,Manchester City,1,2,1.0,0.0,19.0,27.0,0,
20,2.0,24,31,1 - 2,31,1,2,3,RB Leipzig,Club Brugge,0,-1,0.3333333333333333,0.6666666666666666,17.0,7.0,0,
21,2.0,12,5,1 - 5,5,1,5,6,FC Porto,Liverpool,0,-4,0.16666666666666666,0.8333333333333334,10.0,33.0,0,
22,2.0,25,7,1 - 2,7,1,2,3,AC Milan,Atlético Madrid,0,-1,0.3333333333333333,0.6666666666666666,7.0,19.0,0,
23,2.0,13,29,1 - 0,13,1,0,1,Borussia Dortmund,Sporting CP Lisbon,1,1,1.0,0.0,10.0,16.0,0,
24,2.0,1,104,1 - 2,104,1,2,3,Real Madrid,Sheriff Tiraspol,0,-1,0.3333333333333333,0.6666666666666666,30.0,9.0,0,
25,2.0,504,55,1 - 0,504,1,0,1,Atlantas Klaipeda,Young Boys,1,1,1.0,0.0,,8.0,0,
26,2.0,30,86,4 - 0,30,4,0,4,Zenit St. Petersburg,Malmö FF,1,4,1.0,0.0,8.0,5.0,0,
27,2.0,2,33,5 - 0,2,5,0,5,Bayern München,Dynamo Kyiv,1,5,1.0,0.0,26.0,5.0,0,
28,2.0,20,3,3 - 0,20,3,0,3,Benfica,FC Barcelona,1,3,1.0,0.0,20.0,15.0,0,
29,2.0,11,19,2 - 1,11,2,1,3,Manchester United,Villarreal,1,1,0.6666666666666666,0.3333333333333333,18.0,24.0,0,
30,2.0,54,10,1 - 1,10,1,1,2,VfL Wolfsburg,Sevilla,0,0,0.5,0.5,8.0,12.0,0,
31,2.0,28,71,2 - 1,28,2,1,3,FC Salzburg,Lille OSC,1,1,0.6666666666666666,0.3333333333333333,17.0,17.0,0,
32,2.0,6,9,1 - 0,6,1,0,1,Juventus,Chelsea,1,1,1.0,0.0,20.0,25.0,0,
33,3.0,31,4,1 - 5,4,1,5,6,Club Brugge,Manchester City,0,-4,0.16666666666666666,0.8333333333333334,7.0,27.0,0,
34,3.0,46,29,1 - 4,29,1,4,5,Besiktas,Sporting CP Lisbon,0,-3,0.2,0.8,4.0,16.0,0,
35,3.0,8,24,3 - 2,8,3,2,5,Paris Saint-Germain,RB Leipzig,1,1,0.6,0.4,19.0,17.0,0,
36,3.0,12,25,1 - 0,12,1,0,1,FC Porto,AC Milan,1,1,1.0,0.0,10.0,7.0,0,
37,3.0,7,5,2 - 3,5,2,3,5,Atlético Madrid,Liverpool,0,-1,0.4,0.6,19.0,33.0,0,
38,3.0,17,13,4 - 0,17,4,0,4,Ajax,Borussia Dortmund,1,4,1.0,0.0,22.0,10.0,0,
39,3.0,18,104,3 - 1,18,3,1,4,Internazionale,Sheriff Tiraspol,1,2,0.75,0.25,18.0,9.0,0,
40,3.0,21,1,0 - 5,1,0,5,5,Shakhtar Donetsk,Real Madrid,0,-5,0.0,1.0,6.0,30.0,0,
41,3.0,3,33,1 - 0,3,1,0,1,FC Barcelona,Dynamo Kyiv,1,1,1.0,0.0,15.0,5.0,0,
42,3.0,28,54,3 - 1,28,3,1,4,FC Salzburg,VfL Wolfsburg,1,2,0.75,0.25,17.0,8.0,0,
43,3.0,20,2,0 - 4,2,0,4,4,Benfica,Bayern München,0,-4,0.0,1.0,20.0,26.0,0,
44,3.0,55,19,1 - 4,19,1,4,5,Young Boys,Villarreal,0,-3,0.2,0.8,8.0,24.0,0,
45,3.0,11,504,3 - 2,11,3,2,5,Manchester United,Atlantas Klaipeda,1,1,0.6,0.4,18.0,,0,
46,3.0,71,10,0 - 0,10,0,0,0,Lille OSC,Sevilla,0,0,,,17.0,12.0,1,10.0
47,3.0,9,86,4 - 0,9,4,0,4,Chelsea,Malmö FF,1,4,1.0,0.0,25.0,5.0,0,
48,3.0,30,6,0 - 1,6,0,1,1,Zenit St. Petersburg,Juventus,0,-1,0.0,1.0,8.0,20.0,0,
49,4.0,54,28,2 - 1,54,2,1,3,VfL Wolfsburg,FC Salzburg,1,1,0.6666666666666666,0.3333333333333333,8.0,17.0,0,
50,4.0,86,9,0 - 1,9,0,1,1,Malmö FF,Chelsea,0,-1,0.0,1.0,5.0,25.0,0,
51,4.0,33,3,0 - 1,3,0,1,1,Dynamo Kyiv,FC Barcelona,0,-1,0.0,1.0,5.0,15.0,0,
52,4.0,2,20,5 - 2,2,5,2,7,Bayern München,Benfica,1,3,0.7142857142857143,0.2857142857142857,26.0,20.0,0,
53,4.0,19,55,2 - 0,19,2,0,2,Villarreal,Young Boys,1,2,1.0,0.0,24.0,8.0,0,
54,4.0,504,11,2 - 2,11,2,2,4,Atlantas Klaipeda,Manchester United,0,0,0.5,0.5,,18.0,0,
55,4.0,10,71,1 - 2,71,1,2,3,Sevilla,Lille OSC,0,-1,0.3333333333333333,0.6666666666666666,12.0,17.0,0,
56,4.0,6,30,4 - 2,6,4,2,6,Juventus,Zenit St. Petersburg,1,2,0.6666666666666666,0.3333333333333333,20.0,8.0,0,
57,4.0,25,12,1 - 1,12,1,1,2,AC Milan,FC Porto,0,0,0.5,0.5,7.0,10.0,0,
58,4.0,1,21,2 - 1,1,2,1,3,Real Madrid,Shakhtar Donetsk,1,1,0.6666666666666666,0.3333333333333333,30.0,6.0,0,
59,4.0,4,31,4 - 1,4,4,1,5,Manchester City,Club Brugge,1,3,0.8,0.2,27.0,7.0,0,
60,4.0,24,8,2 - 2,8,2,2,4,RB Leipzig,Paris Saint-Germain,0,0,0.5,0.5,17.0,19.0,0,
61,4.0,5,7,2 - 0,5,2,0,2,Liverpool,Atlético Madrid,1,2,1.0,0.0,33.0,19.0,0,
62,4.0,29,46,4 - 0,29,4,0,4,Sporting CP Lisbon,Besiktas,1,4,1.0,0.0,16.0,4.0,0,
63,4.0,13,17,1 - 3,17,1,3,4,Borussia Dortmund,Ajax,0,-2,0.25,0.75,10.0,22.0,0,
64,4.0,104,18,1 - 3,18,1,3,4,Sheriff Tiraspol,Internazionale,0,-2,0.25,0.75,9.0,18.0,0,
65,5.0,33,2,1 - 2,2,1,2,3,Dynamo Kyiv,Bayern München,0,-1,0.3333333333333333,0.6666666666666666,5.0,26.0,0,
66,5.0,19,11,0 - 2,11,0,2,2,Villarreal,Manchester United,0,-2,0.0,1.0,24.0,18.0,0,
67,5.0,3,20,0 - 0,20,0,0,0,FC Barcelona,Benfica,0,0,,,15.0,20.0,1,20.0
68,5.0,55,504,3 - 3,504,3,3,6,Young Boys,Atlantas Klaipeda,0,0,0.5,0.5,8.0,,0,
69,5.0,71,28,1 - 0,71,1,0,1,Lille OSC,FC Salzburg,1,1,1.0,0.0,17.0,17.0,0,
70,5.0,10,54,2 - 0,10,2,0,2,Sevilla,VfL Wolfsburg,1,2,1.0,0.0,12.0,8.0,0,
71,5.0,86,30,1 - 1,30,1,1,2,Malmö FF,Zenit St. Petersburg,0,0,0.5,0.5,5.0,8.0,0,
72,5.0,9,6,4 - 0,9,4,0,4,Chelsea,Juventus,1,4,1.0,0.0,25.0,20.0,0,
73,5.0,46,17,1 - 2,17,1,2,3,Besiktas,Ajax,0,-1,0.3333333333333333,0.6666666666666666,4.0,22.0,0,
74,5.0,18,21,2 - 0,18,2,0,2,Internazionale,Shakhtar Donetsk,1,2,1.0,0.0,18.0,6.0,0,
75,5.0,31,24,0 - 5,24,0,5,5,Club Brugge,RB Leipzig,0,-5,0.0,1.0,7.0,17.0,0,
76,5.0,4,8,2 - 1,4,2,1,3,Manchester City,Paris Saint-Germain,1,1,0.6666666666666666,0.3333333333333333,27.0,19.0,0,
77,5.0,7,25,0 - 1,25,0,1,1,Atlético Madrid,AC Milan,0,-1,0.0,1.0,19.0,7.0,0,
78,5.0,5,12,2 - 0,5,2,0,2,Liverpool,FC Porto,1,2,1.0,0.0,33.0,10.0,0,
79,5.0,29,13,3 - 1,29,3,1,4,Sporting CP Lisbon,Borussia Dortmund,1,2,0.75,0.25,16.0,10.0,0,
80,5.0,104,1,0 - 3,1,0,3,3,Sheriff Tiraspol,Real Madrid,0,-3,0.0,1.0,9.0,30.0,0,
81,6.0,8,31,4 - 1,8,4,1,5,Paris Saint-Germain,Club Brugge,1,3,0.8,0.2,19.0,7.0,0,
82,6.0,24,4,2 - 1,24,2,1,3,RB Leipzig,Manchester City,1,1,0.6666666666666666,0.3333333333333333,17.0,27.0,0,
83,6.0,25,5,1 - 2,5,1,2,3,AC Milan,Liverpool,0,-1,0.3333333333333333,0.6666666666666666,7.0,33.0,0,
84,6.0,12,7,1 - 3,7,1,3,4,FC Porto,Atlético Madrid,0,-2,0.25,0.75,10.0,19.0,0,
85,6.0,13,46,5 - 0,13,5,0,5,Borussia Dortmund,Besiktas,1,5,1.0,0.0,10.0,4.0,0,
86,6.0,17,29,4 - 2,17,4,2,6,Ajax,Sporting CP Lisbon,1,2,0.6666666666666666,0.3333333333333333,22.0,16.0,0,
87,6.0,1,18,2 - 0,1,2,0,2,Real Madrid,Internazionale,1,2,1.0,0.0,30.0,18.0,0,
88,6.0,21,104,1 - 1,104,1,1,2,Shakhtar Donetsk,Sheriff Tiraspol,0,0,0.5,0.5,6.0,9.0,0,
89,6.0,6,86,1 - 0,6,1,0,1,Juventus,Malmö FF,1,1,1.0,0.0,20.0,5.0,0,
90,6.0,30,9,3 - 3,9,3,3,6,Zenit St. Petersburg,Chelsea,0,0,0.5,0.5,8.0,25.0,0,
91,6.0,20,33,2 - 0,20,2,0,2,Benfica,Dynamo Kyiv,1,2,1.0,0.0,20.0,5.0,0,
92,6.0,2,3,3 - 0,2,3,0,3,Bayern München,FC Barcelona,1,3,1.0,0.0,26.0,15.0,0,
93,6.0,11,55,1 - 1,55,1,1,2,Manchester United,Young Boys,0,0,0.5,0.5,18.0,8.0,0,
95,6.0,28,10,1 - 0,28,1,0,1,FC Salzburg,Sevilla,1,1,1.0,0.0,17.0,12.0,0,
96,6.0,54,71,1 - 3,71,1,3,4,VfL Wolfsburg,Lille OSC,0,-2,0.25,0.75,8.0,17.0,0,
94,6.0,504,19,2 - 3,19,2,3,5,Atlantas Klaipeda,Villarreal,0,-1,0.4,0.6,,24.0,0,
97,7.0,8,1,1 - 0,8,1,0,1,Paris Saint-Germain,Real Madrid,1,1,1.0,0.0,19.0,30.0,0,
98,7.0,29,4,0 - 5,4,0,5,5,Sporting CP Lisbon,Manchester City,0,-5,0.0,1.0,16.0,27.0,0,
99,7.0,18,5,0 - 2,5,0,2,2,Internazionale,Liverpool,0,-2,0.0,1.0,18.0,33.0,0,
100,7.0,28,2,1 - 1,2,1,1,2,FC Salzburg,Bayern München,0,0,0.5,0.5,17.0,26.0,0,
101,7.0,19,6,1 - 1,6,1,1,2,Villarreal,Juventus,0,0,0.5,0.5,24.0,20.0,0,
102,7.0,9,71,2 - 0,9,2,0,2,Chelsea,Lille OSC,1,2,1.0,0.0,25.0,17.0,0,
103,7.0,7,11,1 - 1,11,1,1,2,Atlético Madrid,Manchester United,0,0,0.5,0.5,19.0,18.0,0,
104,7.0,20,17,2 - 2,17,2,2,4,Benfica,Ajax,0,0,0.5,0.5,20.0,22.0,0,
105,8.0,2,28,7 - 1,2,7,1,8,Bayern München,FC Salzburg,1,6,0.875,0.125,26.0,17.0,0,
106,8.0,5,18,0 - 1,18,0,1,1,Liverpool,Internazionale,0,-1,0.0,1.0,33.0,18.0,0,
107,8.0,4,29,0 - 0,29,0,0,0,Manchester City,Sporting CP Lisbon,0,0,,,27.0,16.0,1,29.0
108,8.0,1,8,3 - 1,1,3,1,4,Real Madrid,Paris Saint-Germain,1,2,0.75,0.25,30.0,19.0,0,
109,8.0,17,20,0 - 1,20,0,1,1,Ajax,Benfica,0,-1,0.0,1.0,22.0,20.0,0,
110,8.0,11,7,0 - 1,7,0,1,1,Manchester United,Atlético Madrid,0,-1,0.0,1.0,18.0,19.0,0,
111,8.0,71,9,1 - 2,9,1,2,3,Lille OSC,Chelsea,0,-1,0.3333333333333333,0.6666666666666666,17.0,25.0,0,
112,8.0,6,19,0 - 3,19,0,3,3,Juventus,Villarreal,0,-3,0.0,1.0,20.0,24.0,0,
113,9.0,4,7,1 - 0,4,1,0,1,Manchester City,Atlético Madrid,1,1,1.0,0.0,27.0,19.0,0,
114,9.0,20,5,1 - 3,5,1,3,4,Benfica,Liverpool,0,-2,0.25,0.75,20.0,33.0,0,
115,9.0,9,1,1 - 3,1,1,3,4,Chelsea,Real Madrid,0,-2,0.25,0.75,25.0,30.0,0,
116,9.0,19,2,1 - 0,19,1,0,1,Villarreal,Bayern München,1,1,1.0,0.0,24.0,26.0,0,
117,10.0,2,19,1 - 1,19,1,1,2,Bayern München,Villarreal,0,0,0.5,0.5,26.0,24.0,0,
118,10.0,1,9,2 - 3,9,2,3,5,Real Madrid,Chelsea,0,-1,0.4,0.6,30.0,25.0,0,
119,10.0,5,20,3 - 3,20,3,3,6,Liverpool,Benfica,0,0,0.5,0.5,33.0,20.0,0,
120,10.0,7,4,0 - 0,4,0,0,0,Atlético Madrid,Manchester City,0,0,,,19.0,27.0,1,4.0
121,11.0,4,1,4 - 3,4,4,3,7,Manchester City,Real Madrid,1,1,0.5714285714285714,0.42857142857142855,27.0,30.0,0,
122,11.0,5,19,2 - 0,5,2,0,2,Liverpool,Villarreal,1,2,1.0,0.0,33.0,24.0,0,
123,12.0,19,5,2 - 3,5,2,3,5,Villarreal,Liverpool,0,-1,0.4,0.6,24.0,33.0,0,
124,12.0,1,4,3 - 1,1,3,1,4,Real Madrid,Manchester City,1,2,0.75,0.25,30.0,27.0,0,
125,13.0,5,1,0 - 1,1,0,1,1,Liverpool,Real Madrid,0,-1,0.0,1.0,33.0,30.0,0,
1,1.0,43,9,1 - 0,43,1,0,1,Dinamo Zagreb,Chelsea,1,1,1.0,0.0,7.0,21.0,0,
2,1.0,13,38,3 - 0,13,3,0,3,Borussia Dortmund,FC København,1,3,1.0,0.0,18.0,7.0,0,
3,1.0,28,25,1 - 1,25,1,1,2,FC Salzburg,AC Milan,0,0,0.5,0.5,9.0,24.0,0,
4,1.0,50,1,0 - 3,1,0,3,3,Celtic,Real Madrid,0,-3,0.0,1.0,6.0,29.0,0,
5,1.0,24,21,1 - 4,21,1,4,5,RB Leipzig,Shakhtar Donetsk,0,-3,0.2,0.8,18.0,11.0,0,
6,1.0,10,4,0 - 4,4,0,4,4,Sevilla,Manchester City,0,-4,0.0,1.0,21.0,33.0,0,
7,1.0,8,6,2 - 1,8,2,1,3,Paris Saint-Germain,Juventus,1,1,0.6666666666666666,0.3333333333333333,19.0,17.0,0,
8,1.0,20,162,2 - 0,20,2,0,2,Benfica,Maccabi Haifa,1,2,1.0,0.0,25.0,6.0,0,
9,1.0,17,49,4 - 0,17,4,0,4,Ajax,Glasgow Rangers,1,4,1.0,0.0,8.0,4.0,0,
10,1.0,35,29,0 - 3,29,0,3,3,Eintracht Frankfurt,Sporting CP Lisbon,0,-3,0.0,1.0,16.0,14.0,0,
11,1.0,16,5,4 - 1,16,4,1,5,Napoli,Liverpool,1,3,0.8,0.2,25.0,19.0,0,
12,1.0,7,12,2 - 1,7,2,1,3,Atlético Madrid,FC Porto,1,1,0.6666666666666666,0.3333333333333333,8.0,18.0,0,
13,1.0,31,22,1 - 0,31,1,0,1,Club Brugge,Bayer Leverkusen,1,1,1.0,0.0,17.0,19.0,0,
14,1.0,3,60,5 - 1,3,5,1,6,FC Barcelona,Viktoria Plzen,1,4,0.8333333333333334,0.16666666666666666,9.0,4.0,0,
15,1.0,18,2,0 - 2,2,0,2,2,Internazionale,Bayern München,0,-2,0.0,1.0,29.0,27.0,0,
16,1.0,23,42,2 - 0,23,2,0,2,Tottenham Hotspur,Olympique Marseille,1,2,1.0,0.0,18.0,8.0,0,
17,2.0,60,18,0 - 2,18,0,2,2,Viktoria Plzen,Internazionale,0,-2,0.0,1.0,4.0,29.0,0,
18,2.0,29,23,2 - 0,29,2,0,2,Sporting CP Lisbon,Tottenham Hotspur,1,2,1.0,0.0,14.0,18.0,0,
19,2.0,5,17,2 - 1,5,2,1,3,Liverpool,Ajax,1,1,0.6666666666666666,0.3333333333333333,19.0,8.0,0,
21,2.0,12,31,0 - 4,31,0,4,4,FC Porto,Club Brugge,0,-4,0.0,1.0,18.0,17.0,0,
22,2.0,22,7,2 - 0,22,2,0,2,Bayer Leverkusen,Atlético Madrid,1,2,1.0,0.0,19.0,8.0,0,
23,2.0,2,3,2 - 0,2,2,0,2,Bayern München,FC Barcelona,1,2,1.0,0.0,27.0,9.0,0,
24,2.0,42,35,0 - 1,35,0,1,1,Olympique Marseille,Eintracht Frankfurt,0,-1,0.0,1.0,8.0,16.0,0,
25,2.0,25,43,3 - 1,25,3,1,4,AC Milan,Dinamo Zagreb,1,2,0.75,0.25,24.0,7.0,0,
26,2.0,21,50,1 - 1,50,1,1,2,Shakhtar Donetsk,Celtic,0,0,0.5,0.5,11.0,6.0,0,
20,2.0,49,16,0 - 3,16,0,3,3,Glasgow Rangers,Napoli,0,-3,0.0,1.0,4.0,25.0,0,
27,2.0,9,28,1 - 1,28,1,1,2,Chelsea,FC Salzburg,0,0,0.5,0.5,21.0,9.0,0,
28,2.0,1,24,2 - 0,1,2,0,2,Real Madrid,RB Leipzig,1,2,1.0,0.0,29.0,18.0,0,
29,2.0,4,13,2 - 1,4,2,1,3,Manchester City,Borussia Dortmund,1,1,0.6666666666666666,0.3333333333333333,33.0,18.0,0,
30,2.0,38,10,0 - 0,10,0,0,0,FC København,Sevilla,0,0,,,7.0,21.0,1,10.0
31,2.0,6,20,1 - 2,20,1,2,3,Juventus,Benfica,0,-1,0.3333333333333333,0.6666666666666666,17.0,25.0,0,
32,2.0,162,8,1 - 3,8,1,3,4,Maccabi Haifa,Paris Saint-Germain,0,-2,0.25,0.75,6.0,19.0,0,
33,3.0,2,60,5 - 0,2,5,0,5,Bayern München,Viktoria Plzen,1,5,1.0,0.0,27.0,4.0,0,
34,3.0,42,29,4 - 1,42,4,1,5,Olympique Marseille,Sporting CP Lisbon,1,3,0.8,0.2,8.0,14.0,0,
35,3.0,5,49,2 - 0,5,2,0,2,Liverpool,Glasgow Rangers,1,2,1.0,0.0,19.0,4.0,0,
36,3.0,17,16,1 - 6,16,1,6,7,Ajax,Napoli,0,-5,0.14285714285714285,0.8571428571428571,8.0,25.0,0,
37,3.0,12,22,2 - 0,12,2,0,2,FC Porto,Bayer Leverkusen,1,2,1.0,0.0,18.0,19.0,0,
38,3.0,31,7,2 - 0,31,2,0,2,Club Brugge,Atlético Madrid,1,2,1.0,0.0,17.0,8.0,0,
39,3.0,18,3,1 - 0,18,1,0,1,Internazionale,FC Barcelona,1,1,1.0,0.0,29.0,9.0,0,
40,3.0,35,23,0 - 0,23,0,0,0,Eintracht Frankfurt,Tottenham Hotspur,0,0,,,16.0,18.0,1,23.0
41,3.0,28,43,1 - 0,28,1,0,1,FC Salzburg,Dinamo Zagreb,1,1,1.0,0.0,9.0,7.0,0,
42,3.0,24,50,3 - 1,24,3,1,4,RB Leipzig,Celtic,1,2,0.75,0.25,18.0,6.0,0,
43,3.0,9,25,3 - 0,9,3,0,3,Chelsea,AC Milan,1,3,1.0,0.0,21.0,24.0,0,
44,3.0,1,21,2 - 1,1,2,1,3,Real Madrid,Shakhtar Donetsk,1,1,0.6666666666666666,0.3333333333333333,29.0,11.0,0,
45,3.0,4,38,5 - 0,4,5,0,5,Manchester City,FC København,1,5,1.0,0.0,33.0,7.0,0,
46,3.0,10,13,1 - 4,13,1,4,5,Sevilla,Borussia Dortmund,0,-3,0.2,0.8,21.0,18.0,0,
47,3.0,6,162,3 - 1,6,3,1,4,Juventus,Maccabi Haifa,1,2,0.75,0.25,17.0,6.0,0,
48,3.0,20,8,1 - 1,8,1,1,2,Benfica,Paris Saint-Germain,0,0,0.5,0.5,25.0,19.0,0,
49,4.0,38,4,0 - 0,4,0,0,0,FC København,Manchester City,0,0,,,7.0,33.0,1,4.0
50,4.0,162,6,2 - 0,162,2,0,2,Maccabi Haifa,Juventus,1,2,1.0,0.0,6.0,17.0,0,
51,4.0,43,28,1 - 1,28,1,1,2,Dinamo Zagreb,FC Salzburg,0,0,0.5,0.5,7.0,9.0,0,
52,4.0,25,9,0 - 2,9,0,2,2,AC Milan,Chelsea,0,-2,0.0,1.0,24.0,21.0,0,
53,4.0,21,1,1 - 1,1,1,1,2,Shakhtar Donetsk,Real Madrid,0,0,0.5,0.5,11.0,29.0,0,
54,4.0,50,24,0 - 2,24,0,2,2,Celtic,RB Leipzig,0,-2,0.0,1.0,6.0,18.0,0,
55,4.0,13,10,1 - 1,10,1,1,2,Borussia Dortmund,Sevilla,0,0,0.5,0.5,18.0,21.0,0,
56,4.0,8,20,1 - 1,20,1,1,2,Paris Saint-Germain,Benfica,0,0,0.5,0.5,19.0,25.0,0,
57,4.0,16,17,4 - 2,16,4,2,6,Napoli,Ajax,1,2,0.6666666666666666,0.3333333333333333,25.0,8.0,0,
58,4.0,7,31,0 - 0,31,0,0,0,Atlético Madrid,Club Brugge,0,0,,,8.0,17.0,1,31.0
59,4.0,49,5,1 - 7,5,1,7,8,Glasgow Rangers,Liverpool,0,-6,0.125,0.875,4.0,19.0,0,
60,4.0,22,12,0 - 3,12,0,3,3,Bayer Leverkusen,FC Porto,0,-3,0.0,1.0,19.0,18.0,0,
61,4.0,3,18,3 - 3,18,3,3,6,FC Barcelona,Internazionale,0,0,0.5,0.5,9.0,29.0,0,
62,4.0,60,2,2 - 4,2,2,4,6,Viktoria Plzen,Bayern München,0,-2,0.3333333333333333,0.6666666666666666,4.0,27.0,0,
63,4.0,23,35,3 - 2,23,3,2,5,Tottenham Hotspur,Eintracht Frankfurt,1,1,0.6,0.4,18.0,16.0,0,
64,4.0,29,42,0 - 2,42,0,2,2,Sporting CP Lisbon,Olympique Marseille,0,-2,0.0,1.0,14.0,8.0,0,
65,5.0,28,9,1 - 2,9,1,2,3,FC Salzburg,Chelsea,0,-1,0.3333333333333333,0.6666666666666666,9.0,21.0,0,
66,5.0,10,38,3 - 0,10,3,0,3,Sevilla,FC København,1,3,1.0,0.0,21.0,7.0,0,
67,5.0,43,25,0 - 4,25,0,4,4,Dinamo Zagreb,AC Milan,0,-4,0.0,1.0,7.0,24.0,0,
68,5.0,50,21,1 - 1,21,1,1,2,Celtic,Shakhtar Donetsk,0,0,0.5,0.5,6.0,11.0,0,
69,5.0,24,1,3 - 2,24,3,2,5,RB Leipzig,Real Madrid,1,1,0.6,0.4,18.0,29.0,0,
70,5.0,13,4,0 - 0,4,0,0,0,Borussia Dortmund,Manchester City,0,0,,,18.0,33.0,1,4.0
71,5.0,8,162,7 - 2,8,7,2,9,Paris Saint-Germain,Maccabi Haifa,1,5,0.7777777777777778,0.2222222222222222,19.0,6.0,0,
72,5.0,20,6,4 - 3,20,4,3,7,Benfica,Juventus,1,1,0.5714285714285714,0.42857142857142855,25.0,17.0,0,
73,5.0,31,12,0 - 4,12,0,4,4,Club Brugge,FC Porto,0,-4,0.0,1.0,17.0,18.0,0,
74,5.0,18,60,4 - 0,18,4,0,4,Internazionale,Viktoria Plzen,1,4,1.0,0.0,29.0,4.0,0,
75,5.0,16,49,3 - 0,16,3,0,3,Napoli,Glasgow Rangers,1,3,1.0,0.0,25.0,4.0,0,
76,5.0,17,5,0 - 3,5,0,3,3,Ajax,Liverpool,0,-3,0.0,1.0,8.0,19.0,0,
77,5.0,7,22,2 - 2,22,2,2,4,Atlético Madrid,Bayer Leverkusen,0,0,0.5,0.5,8.0,19.0,0,
78,5.0,3,2,0 - 3,2,0,3,3,FC Barcelona,Bayern München,0,-3,0.0,1.0,9.0,27.0,0,
79,5.0,23,29,1 - 1,29,1,1,2,Tottenham Hotspur,Sporting CP Lisbon,0,0,0.5,0.5,18.0,14.0,0,
80,5.0,35,42,2 - 1,35,2,1,3,Eintracht Frankfurt,Olympique Marseille,1,1,0.6666666666666666,0.3333333333333333,16.0,8.0,0,
81,6.0,12,7,2 - 1,12,2,1,3,FC Porto,Atlético Madrid,1,1,0.6666666666666666,0.3333333333333333,18.0,8.0,0,
82,6.0,22,31,0 - 0,31,0,0,0,Bayer Leverkusen,Club Brugge,0,0,,,19.0,17.0,1,31.0
83,6.0,5,16,2 - 0,5,2,0,2,Liverpool,Napoli,1,2,1.0,0.0,19.0,25.0,0,
84,6.0,49,17,1 - 3,17,1,3,4,Glasgow Rangers,Ajax,0,-2,0.25,0.75,4.0,8.0,0,
85,6.0,2,18,2 - 0,2,2,0,2,Bayern München,Internazionale,1,2,1.0,0.0,27.0,29.0,0,
86,6.0,60,3,2 - 4,3,2,4,6,Viktoria Plzen,FC Barcelona,0,-2,0.3333333333333333,0.6666666666666666,4.0,9.0,0,
87,6.0,29,35,1 - 2,35,1,2,3,Sporting CP Lisbon,Eintracht Frankfurt,0,-1,0.3333333333333333,0.6666666666666666,14.0,16.0,0,
88,6.0,42,23,1 - 2,23,1,2,3,Olympique Marseille,Tottenham Hotspur,0,-1,0.3333333333333333,0.6666666666666666,8.0,18.0,0,
89,6.0,1,50,5 - 1,1,5,1,6,Real Madrid,Celtic,1,4,0.8333333333333334,0.16666666666666666,29.0,6.0,0,
90,6.0,21,24,0 - 4,24,0,4,4,Shakhtar Donetsk,RB Leipzig,0,-4,0.0,1.0,11.0,18.0,0,
91,6.0,9,43,2 - 1,9,2,1,3,Chelsea,Dinamo Zagreb,1,1,0.6666666666666666,0.3333333333333333,21.0,7.0,0,
92,6.0,25,28,4 - 0,25,4,0,4,AC Milan,FC Salzburg,1,4,1.0,0.0,24.0,9.0,0,
93,6.0,4,10,3 - 1,4,3,1,4,Manchester City,Sevilla,1,2,0.75,0.25,33.0,21.0,0,
94,6.0,38,13,1 - 1,13,1,1,2,FC København,Borussia Dortmund,0,0,0.5,0.5,7.0,18.0,0,
95,6.0,6,8,1 - 2,8,1,2,3,Juventus,Paris Saint-Germain,0,-1,0.3333333333333333,0.6666666666666666,17.0,19.0,0,
96,6.0,162,20,1 - 6,20,1,6,7,Maccabi Haifa,Benfica,0,-5,0.14285714285714285,0.8571428571428571,6.0,25.0,0,
97,7.0,25,23,1 - 0,25,1,0,1,AC Milan,Tottenham Hotspur,1,1,1.0,0.0,24.0,18.0,0,
98,7.0,8,2,0 - 1,2,0,1,1,Paris Saint-Germain,Bayern München,0,-1,0.0,1.0,19.0,27.0,0,
99,7.0,31,20,0 - 2,20,0,2,2,Club Brugge,Benfica,0,-2,0.0,1.0,17.0,25.0,0,
100,7.0,13,9,1 - 0,13,1,0,1,Borussia Dortmund,Chelsea,1,1,1.0,0.0,18.0,21.0,0,
101,7.0,5,1,2 - 5,1,2,5,7,Liverpool,Real Madrid,0,-3,0.2857142857142857,0.7142857142857143,19.0,29.0,0,
102,7.0,35,16,0 - 2,16,0,2,2,Eintracht Frankfurt,Napoli,0,-2,0.0,1.0,16.0,25.0,0,
103,7.0,24,4,1 - 1,4,1,1,2,RB Leipzig,Manchester City,0,0,0.5,0.5,18.0,33.0,0,
104,7.0,18,12,1 - 0,18,1,0,1,Internazionale,FC Porto,1,1,1.0,0.0,29.0,18.0,0,
105,8.0,20,31,5 - 1,20,5,1,6,Benfica,Club Brugge,1,4,0.8333333333333334,0.16666666666666666,25.0,17.0,0,
106,8.0,9,13,2 - 0,9,2,0,2,Chelsea,Borussia Dortmund,1,2,1.0,0.0,21.0,18.0,0,
108,8.0,2,8,2 - 0,2,2,0,2,Bayern München,Paris Saint-Germain,1,2,1.0,0.0,27.0,19.0,0,
107,8.0,23,25,0 - 0,25,0,0,0,Tottenham Hotspur,AC Milan,0,0,,,18.0,24.0,1,25.0
109,8.0,4,24,7 - 0,4,7,0,7,Manchester City,RB Leipzig,1,7,1.0,0.0,33.0,18.0,0,
110,8.0,12,18,0 - 0,18,0,0,0,FC Porto,Internazionale,0,0,,,18.0,29.0,1,18.0
111,8.0,1,5,1 - 0,1,1,0,1,Real Madrid,Liverpool,1,1,1.0,0.0,29.0,19.0,0,
112,8.0,16,35,3 - 0,16,3,0,3,Napoli,Eintracht Frankfurt,1,3,1.0,0.0,25.0,16.0,0,
113,9.0,20,18,0 - 2,18,0,2,2,Benfica,Internazionale,0,-2,0.0,1.0,25.0,29.0,0,
114,9.0,4,2,3 - 0,4,3,0,3,Manchester City,Bayern München,1,3,1.0,0.0,33.0,27.0,0,
115,9.0,1,9,2 - 0,1,2,0,2,Real Madrid,Chelsea,1,2,1.0,0.0,29.0,21.0,0,
116,9.0,25,16,1 - 0,25,1,0,1,AC Milan,Napoli,1,1,1.0,0.0,24.0,25.0,0,
117,10.0,16,25,1 - 1,25,1,1,2,Napoli,AC Milan,0,0,0.5,0.5,25.0,24.0,0,
118,10.0,9,1,0 - 2,1,0,2,2,Chelsea,Real Madrid,0,-2,0.0,1.0,21.0,29.0,0,
119,10.0,2,4,1 - 1,4,1,1,2,Bayern München,Manchester City,0,0,0.5,0.5,27.0,33.0,0,
120,10.0,18,20,3 - 3,20,3,3,6,Internazionale,Benfica,0,0,0.5,0.5,29.0,25.0,0,
121,11.0,1,4,1 - 1,4,1,1,2,Real Madrid,Manchester City,0,0,0.5,0.5,29.0,33.0,0,
122,11.0,25,18,0 - 2,18,0,2,2,AC Milan,Internazionale,0,-2,0.0,1.0,24.0,29.0,0,
123,12.0,18,25,1 - 0,18,1,0,1,Internazionale,AC Milan,1,1,1.0,0.0,29.0,24.0,0,
124,12.0,4,1,4 - 0,4,4,0,4,Manchester City,Real Madrid,1,4,1.0,0.0,33.0,29.0,0,
125,13.0,4,18,1 - 0,4,1,0,1,Manchester City,Internazionale,1,1,1.0,0.0,33.0,29.0,0,
